staysail	staysails
stead	steads|steading|steaded
steading	steadings
steady	steadiest|steadier|steadying|steadies|steadied
steadying	steadyings
steal	stolen|stealing|stole|steals
stealer	stealers
stealthy	stealthiest|stealthier
steamboat	steamboated|steamboating|steamboats
steamer	steamers|steamered|steamering
steamship	steamships
stearate	stearates
steed	steeds
steek	steeks|steeked|steeking
steeling	steelings
steelworker	steelworkers
steely	steelier|steeliest
steen	steened|steens|steening
steening	steenings
steep	steepest|steeped|steeping|steeper|steeps
steeper	steepers
steeple	steepled|steepling|steeples
steeplechase	steeplechased|steeplechases|steeplechasing
steeplechaser	steeplechasers
steeplejack	steeplejacks
steepy	steepier|steepiest
steer	steers|steered|steering
steerer	steerers
steeve	steeved|steeves|steeving
stein	steins
steinbock	steinbocks
steinkirk	steinkirks
stele	steles
stellate	stellates
stellectomy	stellectomies
stellenbosch	stellenbosches|stellenbosched|stellenbosching
stellionate	stellionates
stem	stemming|stems|stemmed
stemlet	stemlets
stemmer	stemmers
stemmery	stemmeries
stemmy	stemmiest|stemmier
stempel	stempels
stemple	stemples
stempost	stemposts
stemson	stemsons
stench	stenches|stenched|stenching
stencil	stencils|stencilled|stencilling
stenciller	stencillers
stencilling	stencillings
stenograph	stenographing|stenographed|stenographs
stenographer	stenographers
stenographist	stenographists
stenometer	stenometers
stenotherm	stenotherms
stenotype	stenotyped|stenotyping|stenotypes
stenotypist	stenotypists
stentor	stentors
step	steps|stepped|stepping
stepbrother	stepbrothers
stepdame	stepdames
stepdaughter	stepdaughters
stepfather	stepfathers
stephanite	stephanites
stephanotis	stephanotises
stepmother	stepmothers
stepparent	stepparents
stepper	steppers
stepping	steppings
stepsister	stepsisters
stepson	stepsons
steradian	steradians
stercolith	stercoliths
sterculia	sterculias
stere	steres
stereobate	stereobates
stereocamera	stereocameras
stereograph	stereographing|stereographed|stereographs
stereoisomer	stereoisomers
stereometer	stereometers
stereomicroscope	stereomicroscopes
stereophotograph	stereophotographs
stereopticon	stereopticons
stereotype	stereotypes|stereotyping|stereotyped
stereotyper	stereotypers
stereotypist	stereotypists
sterilant	sterilants
sterilise	sterilising|sterilised|sterilises
sterilize	sterilizing|sterilized|sterilizes
sterilizer	sterilizers
sterlet	sterlets
stern	sterner|sterns|sternest
sternotomy	sternotomies
sternpost	sternposts
sternutation	sternutations
sternutative	sternutatives
sternutator	sternutators
sternutatory	sternutatories
sternway	sternways
steroid	steroids
sterol	sterols
stet	stets|stetting|stetted
stethograph	stethographs
stethometer	stethometers
stethoscope	stethoscopes|stethoscoped|stethoscoping
stethoscopist	stethoscopists
stetson	stetsons
stevedore	stevedores|stevedored|stevedoring
stew	stewed|stewing|stews
stewing	stewings
stibine	stibines
stick	sticked|sticking|sticker|stickest|sticks
sticker	stickers|stickered|stickering
sticking	stickings
stickle	stickles|stickling|stickled
stickleback	sticklebacks
stickler	sticklers
stickpin	stickpins
stickup	stickups
sticky	stickiest|stickying|stickies|stickied|stickier
stickybeak	stickybeaking|stickybeaked|stickybeaks
stiff	stiffer|stiffest
stiffener	stiffeners
stiffening	stiffenings
stifle	stifles|stifling|stifled
stifling	stiflings
stigma	stigmata
stigmatic	stigmatics
stigmatise	stigmatised|stigmatising|stigmatises
stigmatize	stigmatizing|stigmatized|stigmatizes
stilb	stilbs
stilbene	stilbenes
stile	stiles|stiling|stiled
stilet	stilets
still	stilling|stills|stilled
stillbirth	stillbirths
stillborn	stillborns
stilling	stillings
stillion	stillions
stilly	stilliest|stillier
stilt	stilts|stilted|stilting
stimulate	stimulated|stimulates|stimulating
stimulater	stimulaters
stimulative	stimulatives
stimulator	stimulators
sting	stinging|stings|stung
stingaree	stingarees
stinger	stingers
stinging	stingings
stingy	stingiest|stingier
stink	stinks|stinking|stunk|stank
stinkard	stinkards
stinker	stinkers
stinking	stinkings
stinkpot	stinkpots
stint	stinted|stinting|stints
stipe	stipes
stipel	stipels
stipend	stipending|stipends|stipended
stipendiary	stipendiaries
stipple	stipples|stippled|stippling
stippler	stipplers
stippling	stipplings
stipulate	stipulates|stipulating|stipulated
stipulation	stipulations
stipulator	stipulators
stir	stirring|stirred|stirs
stirk	stirks
stirrer	stirrers
stirrup	stirrups
stitch	stitches|stitched|stitching
stitcher	stitchers
stithy	stithies
stive	stived|stives|stiving
stiver	stivers
stoat	stoats
stock	stocks|stocked|stocking
stockade	stockading|stockades|stockaded
stockbreeder	stockbreeders
stockbroker	stockbrokers
stockdove	stockdoves
stocker	stockers
stockholder	stockholders
stockholding	stockholdings
stocking	stockings
stockist	stockists
stockjobber	stockjobbers
stockkeeper	stockkeepers
stocklist	stocklists
stockpile	stockpiles|stockpiling|stockpiled
stockpot	stockpots
stockrider	stockriders
stockroom	stockrooms
stockwhip	stockwhipped|stockwhipping|stockwhips
stockwork	stockworks
stocky	stockier|stockiest
stockyard	stockyards
stodge	stodges|stodged|stodging
stoep	stoeps
stogie	stogies
stogy	stogies
stoic	stoics
stoke	stoked|stokes|stoking
stokehold	stokeholds
stokehole	stokeholes
stoker	stokers
stoking	stokings
stole	stoles
stolid	stolidest|stolider
stolon	stolons
stomachache	stomachaches
stomachal	stomachals
stomacher	stomachers
stomachful	stomachfuls
stomachic	stomachics
stomatologist	stomatologists
stomatopathy	stomatopathies
stomatoplasty	stomatoplasties
stomp	stomps|stomping|stomped
stone	stoned|stoning|stones
stonechat	stonechats
stonemason	stonemasons
stoner	stoners
stonewall	stonewalled|stonewalling|stonewalls
stonewalling	stonewallings
stoning	stonings
stony	stoniest|stonier
stooge	stooging|stooged|stooges
stook	stooks|stooking|stooked
stool	stooling|stooled|stools
stoolie	stoolies
stoop	stooping|stoops|stooped
stop	stops|stopping|stopped
stopcock	stopcocks
stope	stoped|stopes|stoping
stopgap	stopgaps
stoplight	stoplights
stoplist	stoplists
stopover	stopovers
stoppage	stoppages
stopper	stoppered|stoppering|stoppers
stopping	stoppings
stopple	stoppling|stopples|stoppled
storable	storables
storage	storages|storaged|storaging
store	storing|stores|stored
storefront	storefronts
storehouse	storehouses|storehousing|storehoused
storekeeper	storekeepers
storeroom	storerooms
storey	storeys
storiette	storiettes
storing	storings
stork	storks
storm	storming|storms|stormed
stormer	stormers
storming	stormings
stormy	stormier|stormiest
story	storying|storied|stories
stot	stotted|stotting|stots
stoup	stoups
stour	stouring|stours|stoured
stoush	stoushing|stoushes|stoushed
stout	stouter|stouts|stoutest
stove	stoves|stoving|stoved
stovepipe	stovepiped|stovepiping|stovepipes
stow	stowing|stowed|stows
stowaway	stowaways
stower	stowers
strabismic	strabismics
strabismometer	strabismometers
strabotomy	strabotomies
straddle	straddles|straddled|straddling
strafe	strafes|strafed|strafing
strafer	strafers
straggle	straggles|straggled|straggling
straggler	stragglers
straggly	straggliest|stragglier
straight	straightest|straights|straighter|straighted|straighting
straightaway	straightaways
straightener	straighteners
straightening	straightenings
straightway	straightways
strain	strained|straining|strains
strainer	strainers
straining	strainings
strainmeter	strainmeters
strainometer	strainometers
strait	straiter|straited|straiting|straitest|straits
straitjacket	straitjacketed|straitjackets|straitjacketing
strake	straking|straked|strakes
strand	stranded|strands|stranding
strander	stranders
stranding	strandings
strange	stranger|stranges|strangest|stranged|stranging
stranger	strangers|strangering|strangered
strangle	strangles|strangled|strangling
stranglehold	strangleholding|strangleheld|strangleholds
strangler	stranglers
strangulate	strangulated|strangulates|strangulating
strap	strapped|straps|strapping
straphanger	straphangers
strapper	strappers
stratagem	stratagems
strategist	strategists
strath	straths
strathspey	strathspeys
stratify	stratifies|stratifying|stratified
stratigrapher	stratigraphers
stratocracy	stratocracies
stratopause	stratopauses
stratosphere	stratospheres
strawberry	strawberried|strawberrying|strawberries
stray	straying|strayed|strays
straying	strayings
streak	streaking|streaks|streaked
streaker	streakers
streaking	streakings
streaky	streakiest|streakier
stream	streamed|streaming|streams
streambed	streambeds
streamer	streamers
streamlet	streamlets
streamline	streamlines|streamlined|streamlining
streamliner	streamliners
streamlining	streamlinings
streamy	streamiest|streamier
street	streeting|streeted|streets
streetcar	streetcars
streetwalker	streetwalkers
strengthening	strengthenings
stress	stressed|stressing|stresses
stretch	stretches|stretched|stretching
stretcher	stretchered|stretchers|stretchering
stretchy	stretchiest|stretchier
strew	strews|strewing|strewed|strewn
striate	striated|striates|striating
striature	striatures
strickle	strickling|strickles|strickled
strict	strictest|stricter
stride	stridden|striding|strode|strides
strident	stridents
stridulate	stridulating|stridulated|stridulates
stridulator	stridulators
strigil	strigils
strike	struck|striking|strikes
strikebreaker	strikebreakers
strikeout	strikeouting|strikeouted|strikeouts
striker	strikers
striking	strikings
string	strings|stringing|strung
stringer	stringers
stringing	stringings
stringy	stringier|stringiest
strip	stripping|strips|stripped
stripe	striped|striping|stripes
striping	stripings
stripling	striplings
stripper	strippers
stripping	strippings
striptease	stripteases|stripteasing|stripteased
stripteaser	stripteasers
stripy	stripier|stripiest
strive	strove|strives|striven|striving
striver	strivers
strobe	strobed|strobing|strobes
strobile	strobiles
strobotron	strobotrons
stroganoff	stroganoffs
stroke	stroked|strokes|stroking
stroll	strolls|strolled|strolling
stroller	strollers
strolling	strollings
strong	strongest|stronger
strongback	strongbacks
stronghold	strongholds
strongpoint	strongpoints
strongyle	strongyles
strop	stropped|stropping|strops
strophe	strophes
strophiole	strophioles
strophoid	strophoids
stroppy	stroppiest|stroppier
strow	strows|strowing|strowed|strown
structural	structurals
structuralise	structuralises|structuralised|structuralising
structuralist	structuralists
structuralize	structuralizes|structuralizing|structuralized
structure	structuring|structures|structured
structuring	structurings
strudel	strudels
struggle	struggling|struggles|struggled
struggler	strugglers
struggling	strugglings
strum	strums|strummed|strumming
strumectomy	strumectomies
strumpet	strumpets|strumpeting|strumpeted
strut	struts|strutting|strutted
strutter	strutters
strutting	struttings
stub	stubbed|stubbing|stubs
stubbing	stubbings
stubbly	stubblier|stubbliest
stubborn	stubborner|stubbornest
stubby	stubbies|stubbier|stubbiest
stucco	stuccoed|stuccoing|stuccos
stuccowork	stuccoworks
stuck	stucks
stud	studded|studs|studding
student	students
studio	studios
study	studying|studied|studies
stuffer	stuffers
stuffy	stuffier|stuffies|stuffiest
stull	stulls
stulm	stulms
stultify	stultifying|stultifies|stultified
stum	stummed|stumming|stums
stumble	stumbling|stumbled|stumbles
stumbler	stumblers
stumer	stumers
stump	stumping|stumped|stumps
stumper	stumpers
stumpy	stumpier|stumpies|stumpiest
stun	stuns|stunning|stunned
stunner	stunners
stunning	stunnings
stunsail	stunsails
stunt	stunted|stunting|stunts
stupa	stupas
stupe	stuping|stuped|stupes
stupefacient	stupefacients
stupefier	stupefiers
stupefy	stupefied|stupefies|stupefying
sturdy	sturdier|sturdiest
stutter	stuttered|stutters|stuttering
stutterer	stutterers
stuttering	stutterings
sty	stying|stied|sties
stye	styes
style	styling|styled|styles
stylet	stylets
styling	stylings
stylisation	stylisations
stylise	stylising|stylises|stylised
stylist	stylists
stylite	stylites
stylization	stylizations
stylize	stylized|stylizes|stylizing
stylo	stylos
stylobate	stylobates
stylograph	stylographs
styloid	styloids
stylolite	stylolites
stymie	stymieing|stymies|stymied
stymy	stymying|stymies|stymied
stype	stypes
styptic	styptics
styrax	styraxes
styrene	styrenes
suave	suaver|suavest|suaves
sub	subbed|subs|subbing
subacetate	subacetates
subacid	subacids
subacute	subacutes
subaddress	subaddresses|subaddressed|subaddressing
subadult	subadults
subagency	subagencies
subagent	subagents
subaggregate	subaggregates
subah	subahs
subahdar	subahdars
subaltern	subalterns
subalternate	subalternates
subarea	subareas
subarray	subarrays
subassembly	subassemblies
subatom	subatoms
subaudition	subauditions
subaverage	subaverages
subbase	subbases
subbing	subbings
subbranch	subbranches
subbreed	subbreeds
subcarbonate	subcarbonates
subcarrier	subcarriers
subcategory	subcategories
subcaudal	subcaudals
subcell	subcells
subchannel	subchannels
subchloride	subchlorides
subclass	subclasses|subclassed|subclassing
subclavian	subclavians
subcommand	subcommands
subcommission	subcommissions
subcommittee	subcommittees
subcompact	subcompacts
subcomplex	subcomplexes
subcomponent	subcomponents
subconsole	subconsoles
subcontinent	subcontinents
subcontract	subcontracted|subcontracting|subcontracts
subcontractor	subcontractors
subcontrary	subcontraries
subcostal	subcostals
subcover	subcovers
subculture	subculturing|subcultures|subcultured
subdeacon	subdeacons
subdeaconship	subdeaconships
subdean	subdeans
subdeb	subdebs
subdebutante	subdebutantes
subdelegate	subdelegating|subdelegates|subdelegated
subdeterminant	subdeterminants
subdiaconate	subdiaconates
subdiagonal	subdiagonals
subdifferential	subdifferentials
subdirector	subdirectors
subdirectory	subdirectories
subdivide	subdivided|subdividing|subdivides
subdocument	subdocuments
subdominant	subdominants
subdrain	subdrained|subdrains|subdraining
subduce	subducing|subduces|subduced
subdue	subdued|subduing|subdues
subdural	subdurals
subeditor	subeditors
subelement	subelements
subentry	subentries
subenvironment	subenvironments
subfamily	subfamilies
subfertility	subfertilities
subfield	subfields
subfile	subfiles
subfix	subfixed|subfixing|subfixes
subflavour	subflavours
subfloor	subfloors
subfolder	subfolders
subform	subforms
subframe	subframes
subfrequency	subfrequencies
subfunctor	subfunctors
subfusc	subfuscs
subgene	subgenes
subgoal	subgoals
subgrade	subgrades
subgradient	subgradients
subgraph	subgraphs
subgroup	subgrouped|subgroups|subgrouping
subharmonic	subharmonics
subhead	subheads
subheader	subheaders
subheading	subheadings
subhuman	subhumans
subinfection	subinfections
subinspector	subinspectors
subinterval	subintervals
subirrigate	subirrigates|subirrigated|subirrigating
subject	subjects|subjected|subjecting
subjectivist	subjectivists
subjoin	subjoining|subjoins|subjoined
subjoint	subjoints
subjugate	subjugated|subjugating|subjugates
subjugator	subjugators
subkingdom	subkingdoms
sublabial	sublabials
sublate	sublating|sublated|sublates
sublattice	sublattices
sublayer	sublayers
sublease	subleased|subleasing|subleases
sublessee	sublessees
sublessor	sublessors
sublet	sublets|subletting
sublevel	sublevels
sublibrary	sublibraries
sublicense	sublicensed|sublicenses|sublicensing
sublieutenant	sublieutenants
sublimate	sublimated|sublimates|sublimating
sublime	subliming|sublimed|sublimer|sublimest|sublimes
subloop	subloops
sublunary	sublunaries
submanager	submanagers
submanifold	submanifolds
submarine	submarined|submarining|submarines
submariner	submariners
submark	submarks|submarking|submarked
submediant	submediants
submenu	submenus
submerge	submerged|submerges|submerging
submerse	submerses|submersing|submersed
submissive	submissives
submit	submitting|submits|submitted
submittal	submittals
submitter	submitters
submodule	submodules
submonoid	submonoids
submultiple	submultiples
subnasal	subnasals
subnet	subnetting|subnets|subnetted
subnetwork	subnetworks
subnitrate	subnitrates
subnormal	subnormals
subobject	subobjects
suboccipital	suboccipitals
subocular	suboculars
suborbital	suborbitals
suborder	suborders
subordinate	subordinates|subordinating|subordinated
suborner	suborners
suboxide	suboxides
subpackage	subpackaging|subpackaged|subpackages
subparameter	subparameters
subpath	subpaths
subpattern	subpatterns
subplot	subplotted|subplotting|subplots
subpool	subpools
subpopulation	subpopulations
subprefect	subprefects
subprefecture	subprefectures
subprior	subpriors
subprocess	subprocesses
subproduct	subproducts
subprogram	subprograms
subprogramme	subprogrammes
subpurchaser	subpurchasers
subquery	subquerying|subqueries|subqueried
subrack	subracks
subrange	subranges
subrector	subrectors
subreflector	subreflectors
subregion	subregions
subregional	subregionals
subrequest	subrequests
subring	subrings
subrogate	subrogates|subrogating|subrogated
subsalt	subsalts
subsample	subsamples|subsampled|subsampling
subsat	subsats
subsaturation	subsaturations
subscapular	subscapulars
subscreen	subscreens
subscribe	subscribing|subscribed|subscribes
subscriber	subscribers
subscribing	subscribings
subscript	subscripting|subscripted|subscripts
subsection	subsectioning|subsectioned|subsections
subsegment	subsegments
subsemigroup	subsemigroups
subserve	subserves|subserving|subserved
subset	subsetting|subsets|subsetted
subshell	subshells
subshrub	subshrubs
subside	subsided|subsides|subsiding
subsider	subsiders
subsidiary	subsidiaries
subsidise	subsidised|subsidises|subsidising
subsidize	subsidizing|subsidized|subsidizes
subsidizer	subsidizers
subsoiler	subsoilers
subsonic	subsonics
substage	substages
substance	substancing|substanced|substances
substantial	substantials
substantialise	substantialised|substantialising|substantialises
substantialist	substantialists
substantialize	substantializing|substantializes|substantialized
substantiate	substantiating|substantiated|substantiates
substantive	substantives|substantived|substantiving
substantivize	substantivized|substantivizing|substantivizes
substate	substates
substation	substations
substituent	substituents
substitute	substitutes|substituting|substituted
substrate	substrated|substrating|substrates
substring	substringed|substrings|substringing
substruction	substructions
substructure	substructures
subsume	subsuming|subsumed|subsumes
subsurface	subsurfaces
subsystem	subsystems
subtangent	subtangents
subtask	subtasks
subtenancy	subtenancies
subtenant	subtenanted|subtenanting|subtenants
subtense	subtenses
subtile	subtiler|subtilest
subtilise	subtilises|subtilised|subtilising
subtilize	subtilizing|subtilized|subtilizes
subtitle	subtitling|subtitles|subtitled
subtitler	subtitlers
subtotal	subtotals|subtotalled|subtotalling
subtracter	subtracters
subtractor	subtractors
subtrahend	subtrahends
subtransaction	subtransactions
subtreasury	subtreasuries
subtree	subtrees
subtriangle	subtriangles
subtribe	subtribes
subtropical	subtropicals
subtype	subtyped|subtyping|subtypes
subumbrella	subumbrellas
subunit	subunits
suburb	suburbs
suburban	suburbans
suburbanise	suburbanises|suburbanising|suburbanised
suburbanite	suburbanites
suburbanize	suburbanizes|suburbanizing|suburbanized
subvalue	subvalues
subvariety	subvarieties
subvector	subvectors
subvene	subvening|subvened|subvenes
subversive	subversives
subvert	subverts|subverting|subverted
subway	subwaying|subways|subwayed
subzone	subzones
succade	succades
succedent	succedents
succeeding	succeedings
successor	successors
succulent	succulents
succursal	succursals
such	suches
sucker	suckered|suckers|suckering
suckfish	suckfishes
suckle	suckling|suckles|suckled
suckling	sucklings
sucrase	sucrases
sudatory	sudatories
sudd	sudds
sudden	suddens
sudorific	sudorifics
sudra	sudras
suds	sudsing|sudsed|sudses
sudsy	sudsiest|sudsier
sue	sues|sued|suing
suede	sueded|suedes|sueding
sufferer	sufferers
suffete	suffetes
suffice	suffices|sufficing|sufficed
suffix	suffixing|suffixes|suffixed
suffocate	suffocating|suffocates|suffocated
suffocating	suffocatings
suffragan	suffragans
suffragist	suffragists
suffuse	suffusing|suffused|suffuses
sugarer	sugarers
sugarplum	sugarplums
sugary	sugarier|sugariest
suggester	suggesters
suicidal	suicidals
suicide	suicided|suicides|suiciding
suit	suiting|suited|suits
suitcase	suitcased|suitcases|suitcasing
suite	suites
suitor	suitored|suitors|suitoring
suitress	suitresses
sulfa	sulfas
sulfamate	sulfamates
sulfanilamide	sulfanilamides
sulfate	sulfates|sulfated|sulfating
sulfhydrate	sulfhydrates
sulfhydryl	sulfhydryls
sulfide	sulfides
sulfinyl	sulfinyls
sulfite	sulfites
sulfonate	sulfonated|sulfonating|sulfonates
sulfone	sulfones
sulfurization	sulfurizations
sulfurize	sulfurized|sulfurizes|sulfurizing
sulk	sulking|sulked|sulks
sulky	sulkiest|sulkier
sullen	sullenest|sullens|sullener
sully	sullying|sullied|sullies
sulpha	sulphas
sulphamate	sulphamates
sulphamide	sulphamides
sulphate	sulphating|sulphates|sulphated
sulphhydryl	sulphhydryls
sulphide	sulphides
sulphinyl	sulphinyls
sulphite	sulphites
sulphocarbonate	sulphocarbonates
sulphomucin	sulphomucins
sulphonamide	sulphonamides
sulphonate	sulphonating|sulphonates|sulphonated
sulphone	sulphones
sulphonyl	sulphonyls
sulphonylurea	sulphonylureas
sulphosalt	sulphosalts
sulphurate	sulphurating|sulphurated|sulphurates
sulphurator	sulphurators
sulphuret	sulphurets
sulphurize	sulphurizing|sulphurizes|sulphurized
sulphuryl	sulphuryls
sulphydrate	sulphydrates
sultanate	sultanates
sultaness	sultanesses
sultry	sultrier|sultriest
sulu	sulus
sum	summing|summed|sums
sumac	sumaced|sumacing|sumacs
sumach	sumached|sumaching|sumaches|sumachs
summand	summands
summarise	summarising|summarises|summarised
summarist	summarists
summarize	summarizes|summarizing|summarized
summate	summated|summates|summating
summer	summered|summers|summering
summering	summerings
summersault	summersaulting|summersaults|summersaulted
summerset	summersets|summersetted|summersetting
summery	summeriest|summerier
summing	summings
summit	summits|summited|summiting
summon	summoned|summons|summoning
summoner	summoners
summons	summonses|summonsed|summonsing
sump	sumped|sumps|sumping
sumph	sumphs
sumpter	sumpters
sumption	sumptions
sun	suns|sunned|sunning
sunbath	sunbaths
sunbathe	sunbathes
sunbeam	sunbeams
sunbed	sunbeds
sunburst	sunbursts
sundae	sundaes
sunder	sundered|sundering|sunders
sundial	sundials
sundowner	sundowners
sundry	sundries
sunflower	sunflowers
sunglass	sunglasses
sunlamp	sunlamps
sunny	sunniest|sunnies|sunnier
sunray	sunrays
sunset	sunsetted|sunsetting|sunsets
sunshade	sunshades
sunspot	sunspots
sunstroke	sunstrokes
sunsuit	sunsuits
suntan	suntanning|suntans|suntanned
suntrap	suntraps
sup	sups|supped|supping
super	supers|supering|supered
superannuate	superannuating|superannuates|superannuated
superb	superbest|superber
superblock	superblocks
superbomb	superbombs
superbus	superbuses
supercalender	supercalenders|supercalendering|supercalendered
supercharacter	supercharacters
supercharge	supercharged|supercharging|supercharges
supercharger	superchargers
superciliary	superciliaries
superclass	superclassed|superclassing|superclasses
supercomplex	supercomplexes
supercomputer	supercomputers
superconductor	superconductors
supercooling	supercoolings
supercrescence	supercrescences
superdominant	superdominants
superdreadnought	superdreadnoughts
superego	superegos
superelevate	superelevating|superelevated|superelevates
superelevation	superelevations
superfamily	superfamilies
superfemale	superfemales
superficial	superficials
superflood	superfloods
superfluid	superfluids
superfunction	superfunctions
supergalaxy	supergalaxies
supergene	supergenes
superglue	supergluing|superglued|superglues
supergrid	supergrids
supergun	superguns
superhard	superhards
superharmonic	superharmonics
superheavy	superheavies
superhet	superhets
superheterodyne	superheterodynes
superhighway	superhighways
superhuman	superhumans
superimpose	superimposed|superimposes|superimposing
superinduce	superinduces|superinduced|superinducing
superinduction	superinductions
superintendent	superintendents
superior	superiors
superioress	superioresses
superjet	superjets
superlative	superlatives
superleak	superleaks
superload	superloads
supermarket	supermarkets
supermart	supermarts
supermastergroup	supermastergroups
supermolecule	supermolecules
supernatural	supernaturals
supernaturalise	supernaturalises|supernaturalising|supernaturalised
supernaturalist	supernaturalists
supernaturalize	supernaturalizes|supernaturalized|supernaturalizing
supernumerary	supernumeraries
superorder	superorders
superorganism	superorganisms
superparasite	superparasites
superplasticizer	superplasticizers
superpose	superposing|superposes|superposed
superprofit	superprofits
superscalar	superscalars
superscribe	superscribes|superscribing|superscribed
supersede	superseding|supersedes|superseded
superset	supersetting|supersets|supersetted
supersoft	supersofts
supersonic	supersonics
supersound	supersounds
superstar	superstars
superstate	superstates
superstock	superstocks
superstore	superstores
superstruction	superstructions
supertanker	supertankers
supertax	supertaxes
supertonic	supertonics
superuser	superusers
supervene	supervenes|supervened|supervening
supervise	supervising|supervises|supervised
supervisor	supervisors
supervoltage	supervoltages
supinate	supinating|supinated|supinates
supinator	supinators
supine	supines
supper	suppers|suppering|suppered
supplanter	supplanters
supple	supplest|suppling|suppler|supples|suppled
supplement	supplemented|supplements|supplementing
supplemental	supplementals
supplementary	supplementaries
suppletive	suppletives
suppletory	suppletories
suppliant	suppliants
supplicant	supplicants
supplicate	supplicated|supplicates|supplicating
supplier	suppliers
supply	supplying|supplied|supplies
supporter	supporters
supporting	supportings
suppose	supposes|supposed|supposing
supposing	supposings
suppress	suppressed|suppressing|suppresses
suppressant	suppressants
suppresser	suppressers
suppressor	suppressors
suppurate	suppurates|suppurating|suppurated
suppurative	suppuratives
supra	supras
supramaxillary	supramaxillaries
supranational	supranationals
supraneural	supraneurals
supraoccipital	supraoccipitals
supraocular	supraoculars
supraorbital	supraorbitals
suprarenal	suprarenals
suprasegmental	suprasegmentals
suprastructure	suprastructures
supremacist	supremacists
supreme	supremed|supremes|supreming
surat	surats
surbase	surbasing|surbased|surbases
surcease	surceasing|surceases|surceased
surcharge	surcharging|surcharged|surcharges
surcingle	surcingled|surcingling|surcingles
surd	surds
sure	surest|surer
suretyship	suretyships
surf	surfing|surfs|surfed
surface	surfaced|surfacing|surfaces
surfacing	surfacings
surfactant	surfactants
surfboard	surfboards|surfboarding|surfboarded
surfie	surfies
surfy	surfiest|surfier
surge	surges|surging|surged
surging	surgings
suricate	suricates
surjection	surjections
surly	surlier|surliest
surmaster	surmasters
surmise	surmising|surmised|surmises
surmullet	surmullets
surname	surnamed|surnaming|surnames
surpass	surpassing|surpassed|surpasses
surpassing	surpassings
surplice	surplices
surplus	surplussing|surpluses|surplussed
surprise	surprising|surprises|surprised
surprising	surprisings
surreal	surreals
surrealist	surrealists
surrebut	surrebuts|surrebutted|surrebutting
surrebutter	surrebutters
surrejoinder	surrejoinders
surrey	surreys
surrogate	surrogating|surrogated|surrogates
surround	surrounded|surrounds|surrounding
surrounding	surroundings
surtax	surtaxed|surtaxing|surtaxes
surtout	surtouts
survey	surveys|surveying|surveyed
surveyor	surveyors
survive	survived|surviving|survives
survivor	survivors
susceptible	susceptibles
susceptivity	susceptivities
susceptometer	susceptometers
suspect	suspected|suspecting|suspects
suspecter	suspecters
suspender	suspenders
suspensoid	suspensoids
suspensor	suspensors
suspensory	suspensories
suspiration	suspirations
suspire	suspires|suspired|suspiring
suss	sussing|sussed|susses
sustain	sustaining|sustains|sustained
sustainer	sustainers
sustaining	sustainings
susu	susus
susurrus	susurruses
sutler	sutlers
sutra	sutras
suttle	suttling|suttles|suttled
suture	sutured|sutures|suturing
suzerain	suzerains
svedberg	svedbergs
svelte	svelter|sveltest
swab	swabbed|swabs|swabbing
swabber	swabbers
swabbing	swabbings
swaddle	swaddling|swaddles|swaddled
swag	swags|swagging|swagged
swage	swaged|swaging|swages
swagger	swaggered|swaggering|swaggers
swaggerer	swaggerers
swain	swains
swale	swaling|swaled|swales
swallet	swallets
swallow	swallowing|swallows|swallowed
swallowing	swallowings
swami	swamis
swamp	swamps|swamped|swamping
swamper	swampers
swampy	swampier|swampiest
swan	swans|swanning|swanned
swank	swanker|swankest
swanky	swankier|swankiest
swannery	swanneries
swap	swaps|swapped|swapping
swapping	swappings
swarajist	swarajists
sward	swarded|swarding|swards
swarf	swarfing|swarfs|swarfed
swarm	swarming|swarmed|swarms
swart	swarter|swarted|swarting|swarts|swartest
swarthy	swarthies|swarthiest|swarthier
swash	swashes|swashing|swashed
swashbuckle	swashbuckled|swashbuckles|swashbuckling
swashbuckler	swashbucklers
swasher	swashers
swashing	swashings
swastica	swasticas
swat	swatting|swats|swatted
swatch	swatched|swatching|swatches
swath	swaths
swathe	swathing|swathes|swathed
swatter	swattering|swatters|swattered
swear	swore|swearing|swears|sworn
swearer	swearers
sweat	sweating|sweated|sweats
sweater	sweaters|sweatered|sweatering
sweaty	sweatier|sweaties|sweatiest
swede	sweded|swedes|sweding
swedge	swedges|swedged|swedging
sweep	sweeps
sweepback	sweepbacks
sweeper	sweepers
sweet	sweetest|sweeter
sweetbread	sweetbreads
sweetgum	sweetgums
sweetie	sweeties
sweeting	sweetings
sweetmeat	sweetmeats
sweetshop	sweetshops
sweety	sweeties
swell	swollen|swelled|swells|swelling
swelter	sweltering|sweltered|swelters
sweltering	swelterings
swerve	swerved|swerving|swerves
swerving	swervings
swift	swifter|swiftest
swig	swigs|swigging|swigged
swim	swims|swimming|swum|swam
swimmer	swimmers
swimmeret	swimmerets
swimmy	swimmies
swimsuit	swimsuits
swindle	swindling|swindled|swindles
swindler	swindlers
swindling	swindlings
swineherd	swineherds
swinery	swineries
swing	swinging|swings|swung
swinge	swinges
swinger	swingers
swingle	swingling|swingled|swingles
swinglebar	swinglebars
swingletree	swingletrees
swink	swunk|swinking|swinks|swank
swipe	swipes|swiped|swiping
swiper	swipers
swirl	swirled|swirling|swirls
swirly	swirliest|swirlier|swirlies
swish	swishes|swishing|swished
swiss	swissed|swissing|swisses
switch	switched|switching|switches
switchback	switchbacking|switchbacks|switchbacked
switchblade	switchblading|switchbladed|switchblades
switchboard	switchboards
switchyard	switchyards
swither	swithers|swithering|swithered
swivel	swivels|swiveled|swiveling
swivelling	swivellings
swizz	swizzes|swizzing|swizzed
swizzle	swizzled|swizzles|swizzling
swob	swobs|swobbing|swobbed
swobber	swobbers
swoon	swooned|swoons|swooning
swoop	swooped|swooping|swoops
swoosh	swooshing|swooshes|swooshed
swop	swopping|swops|swopped
sword	swords
sworder	sworders
swordfish	swordfished|swordfishing|swordfishes
swot	swotting|swots|swotted
swotter	swotters
sybarite	sybarites
sycamine	sycamines
syce	syces
sycophant	sycophanted|sycophants|sycophanting
syllabary	syllabaries
syllabic	syllabics
syllabicate	syllabicates|syllabicating|syllabicated
syllabify	syllabifies|syllabifying|syllabified
syllabise	syllabised|syllabising|syllabises
syllabize	syllabizing|syllabizes|syllabized
syllable	syllabled|syllables|syllabling
syllogise	syllogised|syllogises|syllogising
syllogize	syllogizes|syllogizing|syllogized
sylph	sylphs
sylva	sylvas
sylvan	sylvans
sylvanite	sylvanites
sylvatic	sylvatics
sylvine	sylvines
symbiont	symbionts
symbiotic	symbiotics
symbol	symbols|symboling|symboled
symbolise	symbolised|symbolises|symbolising
symbolist	symbolists
symbolize	symbolized|symbolizing|symbolizes
symmedian	symmedians
symmetrise	symmetrised|symmetrises|symmetrising
symmetrize	symmetrizes|symmetrized|symmetrizing
sympathectomy	sympathectomies
sympathise	sympathised|sympathises|sympathising
sympathiser	sympathisers
sympathize	sympathized|sympathizing|sympathizes
sympathizer	sympathizers
sympathoblast	sympathoblasts
sympathomimetic	sympathomimetics
symphonist	symphonists
symphysiotomy	symphysiotomies
symplectic	symplectics
symptom	symptoms
synagogue	synagogues
synaloepha	synaloephas
synapse	synapses|synapsing|synapsed
sync	synched|synching|syncs
syncarp	syncarps
synchrocyclotron	synchrocyclotrons
synchromesh	synchromeshes
synchronise	synchronises|synchronised|synchronising
synchronize	synchronizes|synchronized|synchronizing
synchronizer	synchronizers
synchrotron	synchrotrons
synclinal	synclinals
syncline	synclines
syncopate	syncopates|syncopated|syncopating
syncretise	syncretising|syncretises|syncretised
syncretist	syncretists
syncretize	syncretized|syncretizing|syncretizes
syncword	syncwords
syncytiotrophoblast	syncytiotrophoblasts
syndactyl	syndactyls
syndesmophyte	syndesmophytes
syndic	syndics
syndicalism	syndicalisms
syndicalist	syndicalists
syndicate	syndicated|syndicates|syndicating
syndrome	syndromes
synergist	synergists
syngraft	syngrafts
synkaryon	synkaryons
synod	synods
synodal	synodals
synoekete	synoeketes
synonym	synonyms
synonymise	synonymising|synonymises|synonymised
synonymist	synonymists
synonymize	synonymizing|synonymizes|synonymized
synoptist	synoptists
synovectomy	synovectomies
syntagm	syntagms
synthesise	synthesised|synthesising|synthesises
synthesiser	synthesisers
synthesist	synthesists
synthesize	synthesizing|synthesizes|synthesized
synthesizer	synthesizers
synthetic	synthetics
synthetise	synthetised|synthetising|synthetises
synthetist	synthetists
synthetize	synthetizes|synthetized|synthetizing
syntonize	syntonizes|syntonized|syntonizing
syphilitic	syphilitics
syphilize	syphilizes|syphilized|syphilizing
syphiloid	syphiloids
syphilologist	syphilologists
syphon	syphoned|syphons|syphoning
syren	syrens
syringa	syringas
syringe	syringed|syringes|syringing
syringocoele	syringocoeles
syringotomy	syringotomies
syrupy	syrupiest|syrupier
sysop	sysopped|sysops|sysopping
system	systems
systematise	systematises|systematising|systematised
systematist	systematists
systematize	systematized|systematizes|systematizing
systematizer	systematizers
systemize	systemizes|systemizing|systemized
systole	systoles
systolic	systolics
systyle	systyles
szomolnokite	szomolnokites
séance	séances|séanced|séancing
tab	tabbed|tabs|tabbing
tabard	tabards
tabby	tabbies|tabbying|tabbied
tabefy	tabefied|tabefies|tabefying
tabernacle	tabernacles|tabernacled|tabernacling
tabetic	tabetics
tabla	tablas
table	tables|tabled|tabling
tableland	tablelands
tablet	tablets|tableted|tableting
tablier	tabliers
tabling	tablings
tabloid	tabloids
tabor	tabored|taboring|tabors
taboret	taborets
tabour	taboured|tabours|tabouring
tabouret	tabourets
tabu	tabus|tabued|tabuing
tabularize	tabularized|tabularizes|tabularizing
tabulate	tabulates|tabulating|tabulated
tabulator	tabulators
tache	taches
tacheometer	tacheometers
tachograph	tachographs
tachometer	tachometers
tachygrapher	tachygraphers
tachymeter	tachymeters
tachysystole	tachysystoles
tack	tacking|tacked|tacks
tackifier	tackifiers
tackle	tackled|tackling|tackles
tacky	tackiest|tackies|tackier
tacnode	tacnodes
taco	tacoing|tacos|tacoed
tactic	tactics
tactical	tacticals
tactician	tacticians
tactometer	tactometers
tactor	tactors
tad	tads
tadpole	tadpoles
tael	taels
taeniafuge	taeniafuges
taenicide	taenicides
taenifuge	taenifuges
tafferel	tafferels
taffrail	taffrails
tag	tags|tagging|tagged
tagger	taggers
tagging	taggings
tagmeme	tagmemes
taiga	taigas
tail	tails|tailed|tailing
tailback	tailbacks
tailboard	tailboards
tailer	tailers
tailfin	tailfins
tailing	tailings
tailor	tailored|tailoring|tailors
tailoress	tailoresses
tailoring	tailorings
tailpiece	tailpieces
tailpipe	tailpipes
tailplane	tailplanes
tailrace	tailraces
taint	tainted|taints|tainting
take	takes|took|taken|taking
takedown	takedowns
taker	takers
talapoin	talapoins
talari	talaris
talbot	talbots
tale	taling|tales|taled
talebearer	talebearers
talent	talents
taleteller	taletellers
taliped	talipeds
talisman	talismans
talkback	talkbacks
talker	talkers
talkie	talkies
talky	talkier|talkiest
tall	tallest|talls|taller
tallboy	tallboys
tally	tallying|tallies|tallied
talon	talons
talus	tali
tamarisk	tamarisks
tambourine	tambourines
tame	tames|tamest|tamer|taming|tamed
tamer	tamers
tammy	tammying|tammied|tammies
tamper	tampering|tampers|tampered
tamperer	tamperers
tampering	tamperings
tampion	tampions
tampon	tamponed|tamponing|tampons
tamponade	tamponades|tamponaded|tamponading
tan	tanned|tanning|tannest|tans|tanner
tana	tanas
tanadar	tanadars
tandem	tandems
tandoori	tandooris
tang	tanging|tangs|tanged
tangent	tangents
tangerine	tangerines
tangible	tangibles
tangle	tangles|tangling|tangled
tangly	tanglier|tangliest
tango	tangoing|tangoes|tangoed
tangy	tangiest|tangier
tank	tanked|tanking|tanks
tankard	tankards
tanker	tankering|tankered|tankers
tanking	tankings
tankwagon	tankwagons
tanna	tannas
tanner	tanners
tannery	tanneries
tannin	tannins
tannoy	tannoys|tannoying|tannoyed
tantalise	tantalising|tantalises|tantalised
tantalize	tantalizing|tantalized|tantalizes
tantalizer	tantalizers
tantalizing	tantalizings
tantalus	tantaluses
tantamount	tantamounted|tantamounting|tantamounts
tantivy	tantivied|tantivying|tantivies
tantony	tantonies
tantra	tantras
tantrum	tantrums|tantruming|tantrumed
tap	tapped|tapping|taps
tape	taping|taped|tapes
taper	tapering|tapers|tapered
tapering	taperings
tapestry	tapestrying|tapestries|tapestried
taphole	tapholes
taphouse	taphouses
taping	tapings
tapir	tapirs
tapis	tapises
tapper	tappers
tappet	tappets
taproom	taprooms
taproot	taproots
tapster	tapsters
tar	tarred|tarring|tars
taradiddle	taradiddles
tarantella	tarantellas
taratantara	taratantaras
tarboosh	tarbooshes
tardigrade	tardigrades
tardo	tardos
tardy	tardies|tardiest|tardied|tardying|tardier
tare	tares|tared|taring
targe	targes
target	targeting|targets|targeted
targeting	targetings
tariff	tariffs|tariffing|tariffed
taring	tarings
tarmac	tarmacked|tarmacs|tarmacking
tarn	tarns
tarnish	tarnishing|tarnished|tarnishes
tarnishing	tarnishings
tarp	tarped|tarping|tarps
tarring	tarrings
tarrock	tarrocks
tarry	tarrying|tarries|tarriest|dated|tarried|tarrier
tarrying	tarryings
tarsal	tarsals
tarsectomy	tarsectomies
tarsorrhaphy	tarsorrhaphies
tart	tartest|tarted|tarts|tarting|tarter
tartan	tartans|tartaning|tartaned
tartlet	tartlets
tartuffe	tartuffes
task	tasked|tasks|tasking
tasker	taskers
tasking	taskings
taskmaster	taskmasters
taskmistress	taskmistresses
tass	tasses
tassel	tasselling|tassels|tasselled
taste	tasting|tasted|tastes
tastelessness	tastelessnesses
taster	tasters
tasting	tastings
tasty	tastiest|tastier
tat	tatted|tats|tatting
tatou	tatous
tatter	tatters|tattered|tattering
tatterdemalion	tatterdemalions
tattle	tattling|tattles|tattled
tattler	tattlers
tattletale	tattletaling|tattletaled|tattletales
tattoo	tattooing|tattoos|tattooed
tattooer	tattooers
tatty	tattier|tatties|tattiest
tatu	tatued|tatus|tatuing
tau	taus
taunt	taunting|taunts|taunted
taunting	tauntings
taut	tautest|tauter
tautochrone	tautochrones
tautologise	tautologised|tautologising|tautologises
tautologist	tautologists
tautologize	tautologized|tautologizing|tautologizes
tautomer	tautomers
tautomerization	tautomerizations
tavern	taverns
taverner	taverners
taw	tawing|tawed|taws
tawdry	tawdrier|tawdriest
tawer	tawers
tawery	taweries
tawny	tawnier|tawniest
tax	taxing|taxes|taxed
taxable	taxables
taxi	taxiing|taxis|taxied|taxies
taxidermist	taxidermists
taxidermy	taxidermies|taxidermied|taxidermying
taximeter	taximeters
taxiplane	taxiplanes
taxiway	taxiways
taxonomist	taxonomists
taxpayer	taxpayers
tbsp	tbsps
tea	teaing|teas|teaed
teach	taught|teaching|teaches
teacher	teachers
teacup	teacups
teagle	teagling|teagled|teagles
team	teaming|teamed|teams
teammate	teammates
teamster	teamsters
teapot	teapots
teapoy	teapoys
tear	tearing|tore|torn|tears
tearaway	tearaways
tease	teases|teased|teasing
teasel	teasels|teaselling|teaselled
teaser	teasers
teat	teats
teazel	teazels
teazle	teazled|teazling|teazles
tec	tecs
techie	techies
technic	technics
technical	technicals
technician	technicians
technicist	technicists
technicolor	technicolors
technocracy	technocracies
technocrat	technocrats
technologist	technologists
techy	techiest|techier
tectosilicate	tectosilicates
ted	teds|tedding|tedded
tedder	teddering|tedders|teddered
tedding	teddings
tedge	tedges
tee	tees|teeing|teed
teen	teened|teens|teening
teenager	teenagers
teener	teeners
teensy	teensiest|teensier
teeny	teenier|teeniest
teepee	teepeeing|teepeed|teepees
teeter	teetered|teeters|teetering
teethe	teething|teethed|teethes
teetotal	teetotals
teetotaler	teetotalers
teetotaller	teetotallers
teetotum	teetotums
teg	tegs
tegument	teguments
tel	tels
telautogram	telautograms
telautograph	telautographs
telco	telcos
telecamera	telecameras
telecardiogram	telecardiograms
telecast	telecasts|telecasting
telecenter	telecenters
telecine	telecines|telecining|telecined
telecom	telecoms
telecommand	telecommands
telecommunicate	telecommunicating|telecommunicated|telecommunicates
telecommute	telecommuted|telecommutes|telecommuting
telecommuter	telecommuters
teleconference	teleconferencing|teleconferenced|teleconferences
telecontrol	telecontrolling|telecontrolled|telecontrols
telecopier	telecopiers
telecopy	telecopying|telecopies|telecopied
telefacsimile	telefacsimiles
telefax	telefaxed|telefaxing|telefaxes
telefilm	telefilms
telegram	telegramming|telegrammed|telegrams
telegraph	telegraphing|telegraphed|telegraphs
telegrapher	telegraphers
telegraphist	telegraphists
telelens	telelenses
telemeeting	telemeetings
telemessage	telemessages
telemeter	telemeters|telemetered|telemetering
telemotor	telemotors
teleobjective	teleobjectives
teleologist	teleologists
telepath	telepathed|telepaths|telepathing
telepathist	telepathists
telepathize	telepathizing|telepathizes|telepathized
telephone	telephones|telephoning|telephoned
telephoner	telephoners
telephonist	telephonists
telephoto	telephotos
telephotograph	telephotographs|telephotographing|telephotographed
telephotometer	telephotometers
telepic	telepics
telepoint	telepoints
teleport	teleporting|teleported|teleports
teleprint	teleprinting|teleprints|teleprinted
teleprompter	teleprompters
telescope	telescoping|telescopes|telescoped
telescoping	telescopings
telescreen	telescreens
telescript	telescripts
teleseism	teleseisms
teleservice	teleservices
telestereoscope	telestereoscopes
telethermometer	telethermometers
telethermoscope	telethermoscopes
telethon	telethons
teletype	teletypes|teletyped|teletyping
teletypewriter	teletypewriters
televiewer	televiewers
televise	televises|televising|televised
televisor	televisors
telewriter	telewriters
telex	telexed|telexes|telexing
tell	told|tells|telling
teller	tellers
telling	tellings
telltale	telltales
tellurate	tellurates
tellurite	tellurites
tellurometer	tellurometers
telnet	telnetting|telnets|telnetted
telocentric	telocentrics
telodendron	telodendrons
telomere	telomeres
telopeptide	telopeptides
telotype	telotypes
telpher	telphers|telphered|telphering
telpherage	telpherages
temp	temping|temps|temped
temperate	temperating|temperated|temperates
temperer	temperers
tempering	temperings
tempest	tempesting|tempested|tempests
templar	templars
template	templates|templating|templated
temple	temples|templing|templed
templet	templets
temporal	temporals
temporalty	temporalties
temporary	temporaries
temporise	temporises|temporised|temporising
temporize	temporized|temporizing|temporizes
temporizer	temporizers
tempter	tempters
tempting	temptings
tenant	tenanted|tenanting|tenants
tenantry	tenantries
tendency	tendencies
tender	tendering|tendered|tenders|tenderest|tenderer
tenderer	tenderers
tendering	tenderings
tenderise	tenderises|tenderised|tenderising
tenderize	tenderizes|tenderizing|tenderized
tenderizer	tenderizers
tenderometer	tenderometers
tendon	tendons
tendril	tendrils
tenectomy	tenectomies
tenement	tenements
tenet	tenets
tenia	tenias
tenner	tenners
tennis	tennised|tennising|tennises
tenon	tenons|tenoned|tenoning
tenoner	tenoners
tenotomy	tenotomies
tense	tensed|tensing|tenser|tenses|tensest
tensimeter	tensimeters
tensiometer	tensiometers
tension	tensions|tensioned|tensioning
tensor	tensoring|tensored|tensors
tent	tenting|tents|tented
tentacle	tentacles
tentative	tentatives
tenter	tentering|tenters|tentered
tenth	tenths|tenthed|tenthing
tenure	tenured|tenuring|tenures
tepee	tepees
tepefy	tepefying|tepefies|tepefied
terabyte	terabytes
teraohm	teraohms
teratism	teratisms
teratogen	teratogens
teratoid	teratoids
tercel	tercels
tercentenary	tercentenaries
tercentennial	tercentennials
tercet	tercets
terebrate	terebrating|terebrates|terebrated
tergiversate	tergiversating|tergiversated|tergiversates
term	terming|terms|termed
termagant	termagants
terminal	terminaling|terminaled|terminals
terminate	terminates|terminating|terminated
terminative	terminatives
terminator	terminators
termitary	termitaries
termite	termites|termited|termiting
tern	terns
ternary	ternaries
ternion	ternions
terpene	terpenes
terpsichorean	terpsichoreans
terrace	terraced|terraces|terracing
terrapin	terrapins
terrestrial	terrestrials
terret	terrets
terricole	terricoles
terrier	terriers
terrify	terrifying|terrifies|terrified
terrine	terrines
territorial	territorials
terrorise	terrorises|terrorised|terrorising
terrorist	terrorists
terrorize	terrorizing|terrorized|terrorizes
terse	terser|tersest
tertian	tertians
tessellate	tessellating|tessellated|tessellates
test	tests|testing|tested
testament	testaments
testate	testates
testator	testators
teste	testes
testee	testees
tester	testers
testicle	testicles
testification	testifications
testificator	testificators
testifier	testifiers
testify	testifying|testified|testifies
testimonial	testimonials
testy	testier|testiest
tetanic	tetanics
tetanize	tetanizes|tetanizing|tetanized
tetanolysin	tetanolysins
tetchy	tetchiest|tetchier
tether	tethering|tethered|tethers
tetra	tetras
tetrachord	tetrachords
tetracosane	tetracosanes
tetracycline	tetracyclines
tetrad	tetrads
tetradactyl	tetradactyls
tetradecane	tetradecanes
tetragon	tetragons
tetragram	tetragrams
tetralogy	tetralogies
tetramethylene	tetramethylenes
tetrasomic	tetrasomics
tetrastyle	tetrastyles
tetrasulfide	tetrasulfides
tetrasyllable	tetrasyllables
tetroxide	tetroxides
tetter	tettering|tetters|tettered
tewel	tewels
text	texting|texts|texted
textbook	textbooks
textile	textiles
textualist	textualists
texture	textured|textures|texturing
texturize	texturizes|texturized|texturizing
thalamotomy	thalamotomies
thalassaemia	thalassaemias
thank	thanks|thanked|thanking
that	thats
thatch	thatching|thatches|thatched
thatcher	thatchers
thaumaturge	thaumaturges
thaumaturgist	thaumaturgists
thaw	thawed|thaws|thawing
thawer	thawers
thawing	thawings
theatrical	theatricals
theatricalism	theatricalisms
theatricize	theatricizing|theatricized|theatricizes
thee	theed|thees|theeing
theist	theists
thelyblast	thelyblasts
thematic	thematics
theme	themed|themes|theming
thenar	thenars
theocrat	theocrats
theocratical	theocraticals
theodolite	theodolites
theogony	theogonies
theologian	theologians
theologize	theologizes|theologizing|theologized
theologue	theologues
theorem	theoreming|theorems|theoremed
theoretician	theoreticians
theorise	theorises|theorising|theorised
theorist	theorists
theorize	theorizes|theorizing|theorized
theorizer	theorizers
theosophist	theosophists
therapeutic	therapeutics
therapeutical	therapeuticals
therapeutist	therapeutists
therapist	therapists
therapy	therapying|therapies|therapied
there	theres
therm	therms
thermal	thermaling|thermaled|thermals
thermalize	thermalizes|thermalized|thermalizing
thermion	thermions
thermobalance	thermobalances
thermobarometer	thermobarometers
thermobattery	thermobatteries
thermocouple	thermocouples
thermocurrent	thermocurrents
thermoduric	thermodurics
thermodynamicist	thermodynamicists
thermoelectron	thermoelectrons
thermoelement	thermoelements
thermogram	thermograms
thermograph	thermographs|thermographing|thermographed
thermohydrometer	thermohydrometers
thermojunction	thermojunctions
thermometer	thermometers
thermopile	thermopiles
thermoregulator	thermoregulators
thermos	thermoses
thermoscope	thermoscopes
thermoset	thermosets
thermosiphon	thermosiphons
thermosphere	thermospheres
thermostat	thermostats
thermoswitch	thermoswitches
thermosyphon	thermosyphons
thermotropism	thermotropisms
thermowell	thermowells
thespian	thespians
theta	thetas
thew	thewed|thews|thewing
thiazoline	thiazolines
thick	thickest|thicker|thicks|thicked|thicking
thickener	thickeners
thicket	thickets
thickhead	thickheads
thickskin	thickskins
thieve	thieved|thieves|thieving
thievery	thieveries
thigh	thighs
thigmotropism	thigmotropisms
thill	thills
thiller	thillers
thimble	thimbles
thimblerig	thimblerigged|thimblerigs|thimblerigging
thimblerigger	thimbleriggers
thin	thinnest|thins|thinned|thinner|thinning
thing	thinged|things|thinging
thingamy	thingamies
thingumajig	thingumajigs
thingumbob	thingumbobs
thingumebob	thingumebobs
thingummy	thingummies
thingy	thingies
think	thinks|thought|thinking
thinker	thinkers
thinner	thinners
thioacid	thioacids
thioalcohol	thioalcohols
thioaldehyde	thioaldehydes
thiocarbamide	thiocarbamides
thioether	thioethers
thionaphthene	thionaphthenes
thionation	thionations
thiophene	thiophenes
thiosulfate	thiosulfates
thiosulphate	thiosulphates
thirsty	thirstiest|thirstier
thirteener	thirteeners
thirteenth	thirteenths
thirtieth	thirtieths
thirty	thirties
this	thises
thistle	thistles
thole	tholes|tholed|tholing
thong	thongs
thoracic	thoracics
thoracoplasty	thoracoplasties
thoracostomy	thoracostomies
thoracotomy	thoracotomies
thorn	thorning|thorned|thorns
thornback	thornbacks
thorny	thorniest|thornier
thorough	thoroughs
thoroughfare	thoroughfares
thorp	thorps
thorpe	thorpes
thou	thoued|thouing|thous
thousandth	thousandths
thrall	thralls|thralling|thralled
thrash	thrashing|thrashes|thrashed
thrashing	thrashings
thread	threads|threaded|threading
threader	threaders
threadworm	threadworms
thready	threadiest|threadier
threat	threating|threated|threats
three	threes
threefold	threefolds
threepenny	threepennies
threescore	threescores
threesome	threesomes
threnode	threnodes
threnody	threnodies
thresh	threshing|threshes|threshed
thresher	threshers
threshing	threshings
threshold	thresholds
thribble	thribbles
thrifty	thriftier|thriftiest
thrill	thrills|thrilling|thrilled
thriller	thrillers
thrilling	thrillings
thrive	thriven|thrives|thriving|throve
thriving	thrivings
throat	throats|throating|throated
throaty	throatiest|throatier
throb	throbs|throbbed|throbbing
throbbing	throbbings
throe	throes|throeing|throed
thrombectomy	thrombectomies
thrombocyte	thrombocytes
thromboembolism	thromboembolisms
thromboendarterectomy	thromboendarterectomies
thromboid	thromboids
thrombolytic	thrombolytics
throne	throning|throned|thrones
throng	throngs|thronging|thronged
throstle	throstles
throttle	throttled|throttles|throttling
through	throughs
throughway	throughways
throw	throws|throwing|thrown|threw
throwaway	throwaways
thrower	throwers
throwing	throwings
thrum	thrumming|thrums|thrummed
thrush	thrushes
thrust	thrusting|thrusts
thruster	thrusters
thrusting	thrustings
thrustor	thrustors
thruway	thruways
thud	thudded|thuds|thudding
thug	thugs|thugging|thugged
thumb	thumbed|thumbs|thumbing
thumbnail	thumbnails|thumbnailing|thumbnailed
thumbprint	thumbprints
thumbscrew	thumbscrews
thumbtack	thumbtacking|thumbtacked|thumbtacks
thump	thumps|thumping|thumped
thumper	thumpers
thunderbolt	thunderbolts
thunderclap	thunderclaps|thunderclapping|thunderclapped
thundercloud	thunderclouds
thunderer	thunderers
thundering	thunderings
thunderpeal	thunderpeals
thundershower	thundershowers
thunderstorm	thunderstorms
thunderstroke	thunderstrokes
thurible	thuribles
thurifer	thurifers
thurify	thurifies|thurifying|thurified
thwack	thwacks|thwacked|thwacking
thwart	thwarting|thwarts|thwarted
thymectomy	thymectomies
thymocyte	thymocytes
thyrofissure	thyrofissures
thyroid	thyroids
thyroidectomy	thyroidectomies
thyroidization	thyroidizations
thyroparathyroidectomy	thyroparathyroidectomies
ti	tis
tiara	tiaras
tibial	tibials
tic	ticced|tics|ticcing
tick	ticking|ticks|ticked
ticker	tickers
ticking	tickings
tickle	tickled|tickling|tickles
tickler	ticklers
tickling	ticklings
tickly	ticklier|tickliest
tiddler	tiddlers
tiddly	tiddlies|tiddlier|tiddliest
tide	tiding|tides|tided
tideway	tideways
tidy	tidied|tidying|tidiest|tidier|tidies
tie	tied|tying|ties
tier	tiered|tiering|tiers
tierce	tierces
tiercel	tiercels
tiercet	tiercets
tiff	tiffing|tiffs|tiffed
tig	tigs
tige	tiges
tiger	tigers
tight	tighter|tightest
tightener	tighteners
tightening	tightenings
tightrope	tightropes
tightwad	tightwads
tike	tikes
til	tils
tilbury	tilburies
tile	tiles|tiled|tiling
tiler	tilers
tilery	tileries
till	tilled|tilling|tills
tiller	tillering|tillered|tillers
tilling	tillings
tilt	tilted|tilting|tilts
tilter	tilters
timbal	timbals
timberling	timberlings
timbrel	timbrels|timbrelling|timbrelled
time	times|timing|timed
timekeeper	timekeepers
timely	timeliest|timelier
timeout	timeouts
timepiece	timepieces
timer	timers
timescale	timescales
timeshare	timeshares
timetable	timetabled|timetables|timetabling
timid	timider|timidest
timist	timists
timoneer	timoneers
timpanist	timpanists
tin	tinned|tinning|tins
tincture	tinctures|tinctured|tincturing
tine	tinest|tined|tining|tiner|tines
ting	tinged|tinging|tings
tinge	tinged|tinging|tinges
tingle	tingles|tingled|tingling
tingling	tinglings
tinhorn	tinhorns
tinker	tinkers|tinkering|tinkered
tinkle	tinkled|tinkling|tinkles
tinkler	tinklers
tinkling	tinklings
tinner	tinners
tinning	tinnings
tinny	tinnies
tinplate	tinplates|tinplating|tinplated
tinsel	tinsels|tinselling|tinselled
tinsmith	tinsmiths
tint	tints|tinting|tinted
tintack	tintacked|tintacking|tintacks
tinter	tinters
tinting	tintings
tintometer	tintometers
tiny	tinier|tiniest|tinies
tip	tips|tipped|tipping
tipper	tippers
tipping	tippings
tipple	tippled|tipples|tippling
tippler	tipplers
tippling	tipplings
tippy	tippies
tipster	tipsters
tipsy	tipsiest|tipsier
tiptoe	tiptoeing|tiptoed|tiptoes
tiptop	tiptops
tirade	tiraded|tirading|tirades
tire	tiring|tired|tires
tiring	tirings
tisane	tisanes
tissue	tissued|tissues|tissuing
tit	titting|titted|tits
titan	titans
titbit	titbits
titer	titers|titering|titered
tithe	tithed|tithes|tithing
tither	tithers
tithing	tithings
titian	titians
titillate	titillates|titillating|titillated
titivate	titivates|titivated|titivating
titlark	titlarks
title	titles|titling|titled
titler	titlers
titling	titlings
titlist	titlists
titrant	titrants
titrate	titrated|titrating|titrates
titre	titring|titred|titres
titter	tittering|titters|tittered
tittivate	tittivates|tittivated|tittivating
tittle	tittling|tittled|tittles
tittlebat	tittlebats
titty	titties
titubate	titubates|titubating|titubated
titular	titulars
titulary	titularies
tizzy	tizzies
toad	toads|toading|toaded
toadskin	toadskins
toadstool	toadstools
toady	toadied|toadying|toadies
toaster	toasters
toasting	toastings
toasty	toastier|toastiest
tobacconist	tobacconists
toboggan	toboggans
tobogganer	tobogganers
tobogganist	tobogganists
toby	tobies
tocher	tochers|tochering|tochered
toco	tocos
tocologist	tocologists
tocsin	tocsins
tod	tods|todding|todded
today	todays
toddle	toddled|toddles|toddling
toddler	toddlers
toe	toes|toeing|toed
toeboard	toeboards
toenail	toenailed|toenails|toenailing
toff	toffs
toffee	toffees|toffeeing|toffeed
toffy	toffier|toffiest
toft	tofts
tog	togging|togs|togged
toggle	toggled|toggling|toggles
toiler	toilers
toilet	toilets|toileted|toileting
toilette	toilettes
toiling	toilings
toing	toings
toke	toked|toking|tokes
token	tokens|tokening|tokened
toko	tokos
tolbooth	tolbooths
tolerate	tolerated|tolerating|tolerates
toll	tolled|tolling|tolls
tollbooth	tollbooths
toller	tollers
tollhouse	tollhouses
tom	toms|tomming|tommed
tomahawk	tomahawked|tomahawks|tomahawking
toman	tomans
tomb	tombing|tombs|tombed
tombola	tombolas
tombolo	tombolos
tomboy	tomboys
tombstone	tombstoned|tombstones|tombstoning
tome	tomes
tomfool	tomfools|tomfooling|tomfooled
tommy	tommies|tommied|tommying
tomnoddy	tomnoddies
tomogram	tomograms
tomorrow	tomorrows
tompion	tompions
tomtit	tomtits
tomtom	tomtommed|tomtoms|tomtomming
ton	tons
tonal	tonals
tone	tones|toned|toning
tong	tonging|tonged|tongs
tonga	tongas
tongue	tongues|tongued|tonguing
tonguelet	tonguelets
tonguing	tonguings
tonic	tonics
toning	tonings
tonk	tonking|tonks|tonked
tonne	tonnes
tonner	tonners
tonometer	tonometers
tonoplast	tonoplasts
tonsil	tonsils
tonsillectomy	tonsillectomies
tonsillolith	tonsilloliths
tonsillotome	tonsillotomes
tonsillotomy	tonsillotomies
tonsor	tonsors
tonsure	tonsures|tonsuring|tonsured
tontine	tontines
tony	toniest|tonies|tonier
tool	tools|tooling|tooled
toolbar	toolbars
toolbox	toolboxes
tooler	toolers
toolie	toolies
toolkit	toolkits
toolmaker	toolmakers
toolpusher	toolpushers
toot	tooting|tooted|toots
toothful	toothfuls
toothing	toothings
toothpick	toothpicked|toothpicks|toothpicking
toothy	toothier|toothiest
tootle	tootling|tootles|tootled
tootling	tootlings
tootsie	tootsies
top	topping|tops|topped
tope	topes|toping|toped
topectomy	topectomies
topee	topees
toper	topers
topgallant	topgallants
topi	topis
topic	topics
topical	topicals
topknot	topknots
topless	toplesses
toplofty	toploftier|toploftiest
topmast	topmasts
topminnow	topminnows
topograph	topographs
topographer	topographers
topographist	topographists
topologist	topologists
toponym	toponyms
topping	toppings
topple	toppled|toppling|topples
topside	topsides
tor	tors
torc	torcs
torch	torches|torching|torched
tore	tores
tormentor	tormentors
tormentress	tormentresses
toroid	toroids
torpedo	torpedoing|torpedoed|torpedoes
torpedoing	torpedoings
torpent	torpents
torpid	torpids
torpify	torpified|torpifying|torpifies
torque	torqued|torquing|torques
torquemeter	torquemeters
torrefy	torrefied|torrefying|torrefies
torrent	torrented|torrents|torrenting
torrid	torridest|torrider
torse	torses
torsel	torsels
torsiograph	torsiographs
torsiometer	torsiometers
torsk	torsks
tort	torts|tortest|torter
torte	tortes
tortilla	tortillas
tortoise	tortoises
torture	tortured|tortures|torturing
torturer	torturers
tory	tories
tosa	tosas
tosh	toshest|tosher|toshed|toshes|toshing
toss	tossing|tossed|tosses
tosspot	tosspots
tot	totting|tots|totted
total	totalled|totalling|totals
totalisator	totalisators
totalise	totalised|totalises|totalising
totalitarian	totalitarians
totalizator	totalizators
totalize	totalizing|totalizes|totalized
totalizer	totalizers
tote	toting|totes|toted
totem	totems
totemist	totemists
totter	tottering|totters|tottered
tottering	totterings
toucan	toucans
touch	touches|touching|touched
toucher	touchers
touching	touchings
touchpad	touchpads
touchscreen	touchscreens
touchstone	touchstones
touchy	touchiest|touchier
tough	toughing|tougher|toughs|toughest|toughed
toughie	toughies
toupee	toupees
toupet	toupets
tour	tours|toured|touring
tourelle	tourelles
tourer	tourers
touring	tourings
tourist	tourists
tournament	tournaments
tourneyer	tourneyers
tourniquet	tourniquets
tousle	tousled|tousling|tousles
tout	touted|touts|touting
touter	touters
tow	tows|towed|towing
towboat	towboats
towel	towels|toweling|toweled
tower	towering|towers|towered
towering	towerings
towing	towings
townee	townees
townie	townies
townlet	townlets
township	townships
towny	townies|towniest|townier
towpath	towpaths
towrope	towropes
toxalbumin	toxalbumins
toxicologist	toxicologists
toxicomania	toxicomanias
toxin	toxins
toxine	toxines
toxophilite	toxophilites
toxophore	toxophores
toy	toyed|toys|toying
toyer	toyers
toying	toyings
toyshop	toyshops
trace	traced|tracing|traces
tracepoint	tracepoints
tracer	tracers
trache	traches
tracheary	trachearies
tracheate	tracheated|tracheating|tracheates
tracheid	tracheids
tracheocele	tracheoceles
tracheophyte	tracheophytes
tracheoscopy	tracheoscopies
tracing	tracings
track	tracks
tracker	trackers
tracklayer	tracklayers
tract	tracted|tracting|tracts
tractate	tractates
tractor	tractored|tractoring|tractors
tractotomy	tractotomies
trade	trades|trading|traded
trademark	trademarked|trademarks|trademarking
tradeoff	tradeoffs
trader	traders
traditional	traditionals
traditionalist	traditionalists
traditionalize	traditionalizing|traditionalizes|traditionalized
traditionary	traditionaries
traduce	traduces|traducing|traduced
traducer	traducers
traducian	traducians
traffic	trafficked|trafficking|traffics
trafficator	trafficators
trafficker	traffickers
tragedian	tragedians
tragedienne	tragediennes
tragic	tragics
trail	trailing|trailed|trails
trailblazer	trailblazers
trailer	trailering|trailered|trailers
trailing	trailings
train	training|trained|trains
trainable	trainables
trainband	trainbands
trainee	trainees
traineeship	traineeships
trainer	trainers
trainload	trainloads
trainmaster	trainmasters
traipse	traipsed|traipsing|traipses
trait	traits
traitor	traitoring|traitors|traitored
traitoress	traitoresses
traitress	traitresses
trajectory	trajectories
tram	tramming|trammed|trams
tramcar	tramcars
trammel	trammels|trammelled|trammelling
trammer	trammers
tramontane	tramontanes
tramp	tramps|tramping|tramped
tramper	trampers
trample	tramples|trampled|trampling
trampler	tramplers
trampoline	trampolined|trampolining|trampolines
trampoliner	trampoliners
trampolinist	trampolinists
tramrail	tramrails
tramroad	tramroads
tramway	tramways
trance	tranced|trancing|trances
tranch	tranched|tranching|tranches
tranche	tranched|tranching|tranches
trannie	trannies
tranny	trannies
tranquil	tranquiler|tranquilest
tranquilize	tranquilized|tranquilizes|tranquilizing
tranquillise	tranquillises|tranquillising|tranquillised
tranquilliser	tranquillisers
tranquillize	tranquillized|tranquillizing|tranquillizes
tranquillizer	tranquillizers
trans	transes|transing|transed
transaction	transactions
transactor	transactors
transadmittance	transadmittances
transaminase	transaminases
transceiver	transceivers
transcendent	transcendents
transcendental	transcendentals
transcendentalist	transcendentalists
transcode	transcoding|transcodes|transcoded
transcoder	transcoders
transcontinental	transcontinentals
transcribe	transcribing|transcribed|transcribes
transcriber	transcribers
transcript	transcripting|transcripted|transcripts
transduce	transduces|transducing|transduced
transducer	transducers
transductor	transductors
transect	transecting|transects|transected
transept	transepts
transexual	transexuals
transfer	transfers|transferring|transferred
transferal	transferals
transferase	transferases
transferee	transferees
transferor	transferors
transferral	transferrals
transferrer	transferrers
transferring	transferrings
transfigure	transfigured|transfiguring|transfigures
transfinite	transfinites
transfix	transfixing|transfixed|transfixes
transform	transforming|transforms|transformed
transformationalist	transformationalists
transformer	transformers
transformist	transformists
transfuse	transfused|transfuses|transfusing
transfusionist	transfusionists
transgress	transgressing|transgressed|transgresses
transgressor	transgressors
tranship	tranships|transhipping|transhipped
transhipment	transhipments
transhipper	transhippers
transhumant	transhumants
transient	transients
transilluminate	transilluminating|transilluminates|transilluminated
transire	transires
transistor	transistors
transistorise	transistorises|transistorised|transistorising
transistorize	transistorizing|transistorizes|transistorized
translate	translated|translates|translating
translative	translatives
translator	translators
transliterate	transliterated|transliterates|transliterating
transloading	transloadings
translocate	translocating|translocated|translocates
translocation	translocations
transmethylation	transmethylations
transmigrant	transmigrants
transmigrate	transmigrating|transmigrates|transmigrated
transmigrator	transmigrators
transmissometer	transmissometers
transmit	transmits|transmitting|transmitted
transmittivity	transmittivities
transmogrification	transmogrifications
transmogrify	transmogrifying|transmogrifies|transmogrified
transmute	transmuted|transmutes|transmuting
transnational	transnationals
transolver	transolvers
transom	transoms
transpassivation	transpassivations
transpierce	transpierced|transpiercing|transpierces
transpire	transpires|transpired|transpiring
transpirometer	transpirometers
transplant	transplanting|transplanted|transplants
transplanter	transplanters
transponder	transponders
transporter	transporters
transporting	transportings
transpose	transposing|transposed|transposes
transputer	transputers
transsexual	transsexuals
transship	transshipping|transshipped|transships
transtainer	transtainers
transubstantiate	transubstantiates|transubstantiated|transubstantiating
transudate	transudates
transude	transudes|transuding|transuded
transuranic	transuranics
transvaluation	transvaluations
transvalue	transvalues|transvalued|transvaluing
transvector	transvectors
transversal	transversals
transverse	transverses|transversed|transversing
transverter	transverters
transvestite	transvestites
trap	traps|trapped|trapping
trapdoor	trapdoors
trapes	trapesing|trapeses|trapesed
trapeze	trapezes|trapezing|trapezed
trapezist	trapezists
trapezoid	trapezoids
trapper	trappers
trapping	trappings
trappy	trappier|trappiest
trapshooter	trapshooters
trash	trashes|trashing|trashed
trashcan	trashcans
trashing	trashings
trashy	trashier|trashiest
traumatic	traumatics
traumatise	traumatising|traumatised|traumatises
traumatism	traumatisms
traumatize	traumatizing|traumatizes|traumatized
trave	traves
travel	travels|travelling|travelled
travelator	travelators
traveler	travelers
traveller	travellers
travelog	travelogs
travelogue	travelogues
traverse	traversed|traversing|traverses
traverser	traversers
traversing	traversings
travesty	travestying|travestied|travesties
trawl	trawling|trawled|trawls
trawler	trawlers
tray	traying|trayed|trays
treacle	treacled|treacling|treacles
treacly	treaclier|treacliest
tread	trod|treads|treading
treadle	treadles|treadling|treadled
treadler	treadlers
treadmill	treadmills
treasure	treasured|treasures|treasuring
treasurer	treasurers
treasury	treasuries
treat	treating|treated|treats
treater	treaters
treatise	treatises
treaty	treaties
treble	trebles|trebled|trebling
trebuchet	trebuchets
trebucket	trebuckets
trecentist	trecentists
tree	treeing|treed|trees
treenail	treenails
trefoil	trefoils
trek	trekking|trekked|treks
trellis	trellising|trellises|trellised
trematode	trematodes
tremble	trembles|trembling|trembled
trembler	tremblers
trembly	tremblier|trembliest
tremor	tremoring|tremors|tremored
tremulant	tremulants
trenail	trenails
trench	trenching|trenches|trenched
trencher	trenchers
trenching	trenchings
trend	trended|trends|trending
trending	trendings
trendline	trendlines
trendsetter	trendsetters
trendy	trendier|trendies|trendiest
trental	trentals
trepan	trepanned|trepanning|trepans
trepang	trepangs
trepanning	trepannings
trephination	trephinations
trephine	trephining|trephines|trephined
treponeme	treponemes
trespass	trespassed|trespassing|trespasses
trespasser	trespassers
tress	tressed|tresses|tressing
tressel	tressels
tressure	tressures
tret	trets
trevally	trevallies
trey	treys
tri	tris
triad	triads
triage	triages|triaged|triaging
trial	trialling|trials|trialled
trialist	trialists
triallist	triallists
triangle	triangles
triangulate	triangulating|triangulates|triangulated
triangulator	triangulators
triarchy	triarchies
triathlon	triathlons
tribade	tribades
tribal	tribals
tribble	tribbles
tribe	tribes|tribed|tribing
triblet	triblets
tribologist	tribologists
tribometer	tribometers
tribulation	tribulations
tribunal	tribunals
tributary	tributaries
tribute	tributed|tributing|tributes
tricar	tricars
trice	triced|trices|tricing
tricentenary	tricentenaries
triceratops	triceratopses
trichinize	trichinized|trichinizes|trichinizing
trichite	trichites
trichocyst	trichocysts
trichome	trichomes
trichomonad	trichomonads
trichophyton	trichophytons
trichopteran	trichopterans
trichord	trichords
trick	tricked|trickest|tricker|tricking|tricks
tricker	trickers
tricking	trickings
trickle	trickling|trickles|trickled
tricklet	tricklets
trickling	tricklings
trickster	tricksters
tricksy	tricksier|tricksiest
tricky	trickiest|trickier
triclad	triclads
tricolor	tricolors
tricolour	tricolours
tricorn	tricorns
tricorne	tricornes
tricosane	tricosanes
tricuspid	tricuspids
tricycle	tricycled|tricycling|tricycles
tricyclic	tricyclics
tridactyl	tridactyls
tridecane	tridecanes
trident	tridents
triennial	triennials
trier	triers
trifacial	trifacials
trifle	trifled|trifling|trifles
trifler	triflers
trifling	triflings
trifoliate	trifoliates
trifurcate	trifurcated|trifurcating|trifurcates
trig	trigged|trigger|trigs|triggest|trigging
trigamist	trigamists
trigeminal	trigeminals
trigger	triggers|triggering|triggered
triggering	triggerings
triglot	triglots
triglyceride	triglycerides
triglyph	triglyphs
trigone	trigones
trigraph	trigraphs
trihybrid	trihybrids
trijet	trijets
trike	triked|trikes|triking
trilingual	trilinguals
triliteral	triliterals
trill	trilled|trilling|trills
triller	trillers
trilling	trillings
trillion	trillions
trilobite	trilobites
trilogy	trilogies
trim	trimming|trimmed|trims|trimmest|trimmer
trimaran	trimarans
trimerize	trimerizes|trimerizing|trimerized
trimester	trimesters
trimeter	trimeters
trimmer	trimmers
trimming	trimmings
trimonthly	trimonthlies
trimorph	trimorphs
trimotor	trimotors
trinary	trinaries
trindle	trindled|trindling|trindles
trine	trines|trining|trined
tringle	tringles
triniscope	triniscopes
trinitarian	trinitarians
trinitrotoluene	trinitrotoluenes
trinity	trinities
trinket	trinkets|trinketing|trinketed
trio	trios
triode	triodes
triol	triols
triolet	triolets
triose	trioses
trip	trips|tripping|tripped
triphibian	triphibians
triphone	triphones
triphthong	triphthongs
triplane	triplanes
triple	tripling|triples|tripled
tripler	triplers
triplet	triplets
triplex	triplexed|triplexes|triplexing
triplexer	triplexers
triplicate	triplicates|triplicating|triplicated
tripling	triplings
triploid	triploids
tripod	tripoding|tripods|tripoded
tripos	triposes
tripper	trippers
tripping	trippings
trireme	triremes
trishaw	trishaws
trisomic	trisomics
triste	tristes
trisyllabic	trisyllabics
trisyllable	trisyllables
tritanope	tritanopes
trite	triter|tritest
tritheist	tritheists
tritium	tritiums
triton	tritons
tritone	tritones
triturate	triturated|triturating|triturates
triturator	triturators
triumphal	triumphals
triumphalism	triumphalisms
triumpher	triumphers
triumvirate	triumvirates
trivalent	trivalents
trivector	trivectors
trivet	trivets
trivial	trivials
trivialisation	trivialisations
trivialise	trivialises|trivialising|trivialised
trivialization	trivializations
trivialize	trivializes|trivialized|trivializing
triweekly	triweeklies
troat	troated|troating|troats
trocar	trocars
trochaic	trochaics
trochanter	trochanters
trochar	trochars
troche	troches
trochee	trochees
trochlear	trochlears
trod	trods
troffer	troffers
troglodyte	troglodytes
troika	troikas
troilite	troilites
trojan	trojaned|trojans|trojaning
troll	trolling|trolled|trolls
trolley	trollies|trolleying|trolleys|trolleyed
trollop	trolloped|trolloping|trollops
trolly	trollies|trollied|trollying
trombone	tromboning|tromboned|trombones
trombonist	trombonists
trommel	trommels
tromometer	tromometers
tron	trons
trone	trones
troop	troops|trooped|trooping
trooper	troopering|troopered|troopers
trooping	troopings
troopship	troopships
trope	tropes|troped|troping
trophoblast	trophoblasts
trophocyte	trophocytes
trophozoite	trophozoites
trophy	trophying|trophies|trophied
tropic	tropics
tropical	tropicals
tropicalise	tropicalises|tropicalising|tropicalised
tropicalize	tropicalized|tropicalizing|tropicalizes
tropine	tropines
tropist	tropists
tropometer	tropometers
tropomyosin	tropomyosins
tropopause	tropopauses
tropophyte	tropophytes
troposphere	tropospheres
trot	trotting|trotted|trots
trotline	trotlines
trotter	trotters
trotting	trottings
troubadour	troubadours
trouble	troubling|troubled|troubles
troublemaker	troublemakers
troubler	troublers
troubleshoot	troubleshoots|troubleshooting|troubleshot
troubleshooter	troubleshooters
trough	troughing|troughs|troughed
trounce	trounced|trounces|trouncing
troupe	trouped|troupes|trouping
trouper	troupers
trouser	trousering|trousered|trousers
trousering	trouserings
troutlet	troutlets
troutling	troutlings
trouty	troutier|troutiest
trove	troves
trowel	trowels|troweling|troweled
truant	truanting|truants|truanted
truce	truces
truck	trucking|trucks|trucked
truckdriver	truckdrivers
trucker	truckers
truckle	truckles|truckled|truckling
truckler	trucklers
truckload	truckloads
truckmaster	truckmasters
trudge	trudging|trudges|trudged
trudgen	trudgens
truepenny	truepennies
truffle	truffles
trug	trugs
truism	truisms
trull	trulls
trump	trumped|trumps|trumping
trumpery	trumperies
trumpet	trumpeting|trumpets|trumpeted
trumpeter	trumpeters
truncate	truncates|truncated|truncating
truncheon	truncheoned|truncheoning|truncheons
trundle	trundles|trundling|trundled
trundler	trundlers
trunk	trunks|trunking|trunked
trunker	trunkers
trunnion	trunnions
truss	trusses|trussed|trussing
trussing	trussings
trustee	trusteeing|trustees|trusteed
truster	trusters
trustify	trustifies|trustified|trustifying
trustor	trustors
trustworthy	trustworthier|trustworthiest
trusty	trustier|trustiest|trusties
try	trying|tries|tried
trying	tryings
trypanid	trypanids
trypanocide	trypanocides
trypanosome	trypanosomes
trypanosomicide	trypanosomicides
trysail	trysails
tryst	trysting|trysts|trysted
tsarevitch	tsarevitches
tsarist	tsarists
tsaritza	tsaritzas
tscheffkinite	tscheffkinites
tsotsi	tsotsis
tsp	tsps
tub	tubbed|tubbing|tubs
tuba	tubas
tubby	tubbies|tubbiest|tubbier
tube	tubing|tubes|tubed
tuber	tubers
tubercle	tubercles
tuberculid	tuberculids
tuberculise	tuberculised|tuberculising|tuberculises
tuberculize	tuberculized|tuberculizing|tuberculizes
tuberculotic	tuberculotics
tuberose	tuberoses
tubifex	tubifexes
tubulate	tubulated|tubulates|tubulating
tubule	tubules
tubulocyst	tubulocysts
tubulure	tubulures
tuck	tucking|tucks|tucked
tucker	tuckers|tuckering|tuckered
tue	tues
tuff	tuffer|tuffest
tuffet	tuffets
tuft	tufted|tufting|tufts
tufty	tuftiest|tuftier|tufties
tug	tugged|tugging|tugs
tugboat	tugboats
tugger	tuggers
tugging	tuggings
tugrik	tugriks
tulip	tulips
tum	tums
tumble	tumbled|tumbling|tumbles
tumblehome	tumblehomes
tumbler	tumblers
tumbling	tumblings
tumbrel	tumbrels
tumbril	tumbrils
tumefy	tumefies|tumefied|tumefying
tummy	tummies
tumour	tumours
tumult	tumults|tumulted|tumulting
tun	tunning|tunned|tuns
tunable	tunables
tundish	tundishes
tune	tuning|tuned|tunes
tuner	tuners
tunesmith	tunesmiths
tung	tungs
tungstate	tungstates
tunic	tunics
tunicate	tunicates
tunicle	tunicles
tunnel	tunnelling|tunnelled|tunnels
tunneller	tunnellers
tunny	tunnies
tup	tupped|tupping|tups
tuple	tuples
tuppenny	tuppennies
turban	turbans
turbary	turbaries
turbidimeter	turbidimeters
turbinate	turbinates|turbinated|turbinating
turbine	turbines
turbinectomy	turbinectomies
turbinotomy	turbinotomies
turbit	turbits
turbo	turboing|turboed|turbos
turbocharger	turbochargers
turbocompressor	turbocompressors
turbodrill	turbodrills
turboexpander	turboexpanders
turbogenerator	turbogenerators
turbulization	turbulizations
turd	turds
tureen	tureens
turfite	turfites
turfy	turfier|turfiest
turn	turns|turning|turned
turnagain	turnagains
turnbuckle	turnbuckles
turncoat	turncoats
turncock	turncocks
turner	turners
turning	turnings
turnip	turnips|turniping|turniped
turnkey	turnkeys|turnkeyed|turnkeying
turnoff	turnoffs
turnout	turnouts
turnpike	turnpikes|turnpiked|turnpiking
turnplate	turnplates
turnround	turnrounds
turnscrew	turnscrews
turnspit	turnspits
turnstile	turnstiles
turntable	turntabled|turntabling|turntables
turpentine	turpentines|turpentined|turpentining
turret	turrets
turtle	turtled|turtling|turtles
turtler	turtlers
tush	tushing|tushed|tushes
tusk	tusks|tusked|tusking
tusker	tuskers
tusky	tuskiest|tuskier
tussle	tussled|tussling|tussles
tussock	tussocks
tussur	tussurs
tut	tutted|tuts|tutting
tutee	tutees
tutelar	tutelars
tutelary	tutelaries
tutoress	tutoresses
tutorship	tutorships
tutti	tuttis
tutu	tutuing|tutued|tutus
tux	tuxes
tuyere	tuyeres
tuyère	tuyères
twaddle	twaddling|twaddled|twaddles
twaddler	twaddlers
twain	twained|twains|twaining
twang	twanged|twangs|twanging
twat	twatted|twatting|twats
tweak	tweaks|tweaked|tweaking
tweaker	tweakers
tweedle	tweedling|tweedled|tweedles
tweedy	tweedier|tweediest
tween	tweened|tweens|tweening
tweeny	tweenies
tweet	tweeting|tweets|tweeted
tweeze	tweezes|tweezing|tweezed
tweezer	tweezered|tweezers|tweezering
twelfth	twelfths
twelve	twelves
twelvemo	twelvemos
twelvemonth	twelvemonths
twelver	twelvers
twentieth	twentieths
twenty	twenties
twerp	twerps
twibil	twibils
twibill	twibills
twicer	twicers
twiddle	twiddling|twiddled|twiddles
twiddly	twiddliest|twiddlier
twig	twigging|twigged|twigs
twiggy	twiggiest|twiggier
twilight	twilit|twilights|twilighting
twin	twinned|twins|twinning
twine	twining|twines|twined
twiner	twiners
twinge	twinged|twinges|twingeing
twinkle	twinkling|twinkled|twinkles
twinkling	twinklings
twinning	twinnings
twip	twips
twirl	twirled|twirling|twirls
twirp	twirps
twist	twisting|twists|twisted
twister	twisters
twistor	twistors
twisty	twisties|twistier|twistiest
twit	twitting|twits|twitted
twitch	twitched|twitching|twitches
twitchy	twitchier|twitchiest
twite	twites
two	twos
twofer	twofers
twosome	twosomes
twyer	twyers
tycoon	tycoons
tye	tyes|tyeing|tyed
tying	tyings
tyke	tykes
tympan	tympans
tympanal	tympanals
tympanectomy	tympanectomies
tympanic	tympanics
tympanist	tympanists
tympanotomy	tympanotomies
type	types
typecase	typecases
typeface	typefaces
typer	typers
typescript	typescripts
typeset	typesetting|typesets
typesetter	typesetters
typestyle	typestyles
typewrite	typewrote|typewrites|typewriting|typewritten
typewriter	typewriters
typhoid	typhoids
typhoon	typhoons|typhooning|typhooned
typical	typicals
typify	typifies|typified|typifying
typo	typos|typoed|typoing
typographer	typographers
typologist	typologists
typonym	typonyms
tyrannise	tyrannises|tyrannising|tyrannised
tyrannize	tyrannized|tyrannizing|tyrannizes
tyrannizer	tyrannizers
tyrant	tyrants|tyranted|tyranting
tyre	tyring|tyres|tyred
tyrolean	tyroleans
tysonite	tysonites
tzar	tzars
tzarina	tzarinas
tzarist	tzarists
tzigane	tziganes
uakari	uakaris
ubiquinone	ubiquinones
ubiquitary	ubiquitaries
udder	udders
udometer	udometers
uglifier	uglifiers
uglify	uglifies|uglified|uglifying
ugly	uglies|uglied|uglying|ugliest|uglier
uhlan	uhlans
ukase	ukases
ukulele	ukuleles
ulcer	ulcers
ulcerate	ulcerating|ulcerates|ulcerated
uliginose	uliginoses
ullage	ullaged|ullaging|ullages
ullmannite	ullmannites
ulnare	ulnares
ulster	ulsters
ult	ults
ultimate	ultimates|ultimated|ultimating
ultra	ultras
ultrabasic	ultrabasics
ultracentrifugation	ultracentrifugations
ultracentrifuge	ultracentrifuged|ultracentrifuging|ultracentrifuges
ultraconservative	ultraconservatives
ultrafiche	ultrafiches
ultrafilter	ultrafilters
ultrafiltrate	ultrafiltrated|ultrafiltrating|ultrafiltrates
ultraist	ultraists
ultraliberal	ultraliberals
ultramicrometer	ultramicrometers
ultramicroscope	ultramicroscopes
ultramicrotome	ultramicrotoming|ultramicrotomed|ultramicrotomes
ultramodernist	ultramodernists
ultramontane	ultramontanes
ultramontanist	ultramontanists
ultranationalist	ultranationalists
ultrasonoscope	ultrasonoscopes
ululate	ululates|ululating|ululated
ululation	ululations
um	ums|ummed|umming
umbel	umbels
umbellifer	umbellifers
umber	umbering|umbers|umbered
umbilical	umbilicals
umbilication	umbilications
umbrage	umbrages|umbraging|umbraged
umbrella	umbrellaing|umbrellas|umbrellaed
umpire	umpires|umpired|umpiring
un	uns
unable	unables|unabling|unabled
unacceptable	unacceptables
unaffected	unaffecteds
unanswerable	unanswerables
unappropriate	unappropriated|unappropriating|unappropriates
unary	unaries
unassailable	unassailables
unassemble	unassembling|unassembles|unassembled
unattainable	unattainables
unattractive	unattractives
unavailable	unavailables
unavoidable	unavoidables
unbalance	unbalances|unbalanced|unbalancing
unban	unbans|unbanned|unbanning
unbandage	unbandaged|unbandages|unbandaging
unbar	unbarred|unbars|unbarring
unbarricade	unbarricades|unbarricaded|unbarricading
unbear	unbearing|unborne|unbore|unbears
unbeatable	unbeatables
unbecome	unbecomes|unbecoming|unbecame
unbecoming	unbecomings
unbeliever	unbelievers
unbend	unbending|unbent|unbends
unbending	unbendings
unbethink	unbethinking|unbethinks|unbethought
unbias	unbiased|unbiasing|unbiases
unbind	unbinds|unbinding|unbound
unbirthday	unbirthdays
unblocker	unblockers
unblocking	unblockings
unbosomer	unbosomers
unbox	unboxes|unboxing|unboxed
unbrace	unbracing|unbraces|unbraced
unbreakable	unbreakables
unbreech	unbreeching|unbreeched|unbreeches
unbridle	unbridling|unbridles|unbridled
unbuckle	unbuckling|unbuckles|unbuckled
unbuild	unbuilding|unbuilt|unbuilds
unbundling	unbundlings
unbury	unburying|unburies|unburied
unbusy	unbusied|unbusies|unbusying
unbuttoning	unbuttonings
uncage	uncaging|uncaged|uncages
uncanny	uncannier|uncanniest
uncap	uncaps|uncapping|uncapped
uncase	uncases|uncasing|uncased
unchangeable	unchangeables
uncharge	uncharging|uncharged|uncharges
unchewable	unchewables
unchoke	unchokes|unchoked|unchoking
unchristianise	unchristianises|unchristianising|unchristianised
unchristianize	unchristianized|unchristianizing|unchristianizes
unchurch	unchurched|unchurching|unchurches
uncial	uncials
unciform	unciforms
uncle	uncling|uncles|uncled
unclean	uncleanest|uncleaner
unclench	unclenching|unclenches|unclenched
unclog	unclogs|unclogged|unclogging
unclose	unclosing|uncloses|unclosed
unclothe	unclothing|unclothes|unclothed
unclue	uncluing|unclued|unclues
unclutch	unclutched|unclutches|unclutching
uncoiling	uncoilings
uncollectible	uncollectibles
uncomely	uncomeliest|uncomelier
uncommercial	uncommercials
uncommon	uncommonest|uncommoner
uncompress	uncompresses|uncompressed|uncompressing
unconcern	unconcerns
unconfigure	unconfigures|unconfiguring|unconfigured
unconscious	unconsciouses
unconventional	unconventionals
uncountable	uncountables
uncouple	uncouples|uncoupled|uncoupling
uncoupler	uncouplers
uncoupling	uncouplings
uncovering	uncoverings
uncrate	uncrating|uncrated|uncrates
uncreate	uncreating|uncreated|uncreates
uncross	uncrossed|uncrossing|uncrosses
undecagon	undecagons
undeceive	undeceived|undeceives|undeceiving
undecided	undecideds
undeclinable	undeclinables
undefinable	undefinables
undefine	undefined|undefining|undefines
undeliverable	undeliverables
underachieve	underachieved|underachieves|underachieving
underachievement	underachievements
underachiever	underachievers
underactor	underactors
underarm	underarms|underarming|underarmed
underback	underbacks
underbake	underbakes|underbaked|underbaking
underbelly	underbellies
underbid	underbids|underbidding
underbidder	underbidders
underblanket	underblankets
underbody	underbodies
underbridge	underbridges
underbrim	underbrims
underbrush	underbrushing|underbrushes|underbrushed
underbuy	underbuys|underbuying|underbought
undercapitalise	undercapitalises|undercapitalised|undercapitalising
undercapitalize	undercapitalizes|undercapitalizing|undercapitalized
undercart	undercarts
undercharge	undercharges|undercharged|undercharging
underclass	underclasses
underclay	underclays
underclerk	underclerks
undercoat	undercoating|undercoated|undercoats
undercompensation	undercompensations
undercook	undercooking|undercooked|undercooks
undercover	undercovered|undercovers|undercovering
undercreep	undercrept|undercreeps|undercreeping
undercroft	undercrofts
undercrossing	undercrossings
undercurrent	undercurrenting|undercurrents|undercurrented
undercut	undercutting|undercuts
undercutter	undercutters
undercutting	undercuttings
underdo	underdid|underdoes|underdoing|underdone
underdog	underdogs
underdose	underdoses|underdosing|underdosed
underdrain	underdrained|underdraining|underdrains
underdraw	underdrawn|underdrew|underdrawing|underdraws
underdrive	underdriven|underdrives|underdrove|underdriving
underemphasise	underemphasised|underemphasises|underemphasising
underemphasize	underemphasizing|underemphasized|underemphasizes
underestimate	underestimated|underestimates|underestimating
underexpose	underexposed|underexposing|underexposes
underfeed	underfeeds|underfed|underfeeding
underfloor	underfloors
underflow	underflowing|underflowed|underflows
underfoot	underfooted|underfooting|underfoots
underframe	underframes
undergarment	undergarments
underglaze	underglazing|underglazes|underglazed
undergo	undergoes|underwent|undergoing|undergone
undergrad	undergrads
undergrade	undergraded|undergrading|undergrades
undergraduate	undergraduates
undergrip	undergrips
underground	undergrounding|undergrounds|undergrounded
undergrounder	undergrounders
underhand	underhanding|underhands|underhanded
underinsured	underinsureds
underlap	underlaps|underlapping|underlapped
underlay	underlays
underlayer	underlayering|underlayers|underlayered
underlease	underleasing|underleases|underleased
underlessee	underlessees
underlet	underlets|underletting
underletter	underletters
underlie	underlain|underlay|underlying|underlies
underline	underlined|underlining|underlines
underling	underlings
underlining	underlinings
underlip	underlips
underload	underloading|underloads|underloaded
underlook	underlooks|underlooking|underlooked
underlying	underlyings
undermaster	undermasters
undermeaning	undermeanings
undermine	undermining|undermined|undermines
undermining	underminings
undernourish	undernourishing|undernourished|undernourishes
underpart	underparts|underparting|underparted
underpass	underpasses
underpay	underpays|underpaid|underpaying
underpin	underpinning|underpinned|underpins
underplanting	underplantings
underplate	underplating|underplates|underplated
underplot	underplots
underpraise	underpraising|underpraises|underpraised
underpressure	underpressures
underprice	underpricing|underpriced|underprices
underproduce	underproduced|underproduces|underproducing
underprop	underpropping|underprops|underpropped
underquote	underquoting|underquotes|underquoted
underrate	underrating|underrates|underrated
underrun	underran|underrunning|underruns
underscore	underscoring|underscored|underscores
underseal	underseals|undersealed|undersealing
undersecretary	undersecretaries
undersell	underselling|undersells|undersold
underseller	undersellers
underset	undersetting|undersets
undershirt	undershirts
undershoot	undershooting|undershoots|undershot
undershot	undershots
undershrub	undershrubs
underside	undersides
underskirt	underskirts
undersleeve	undersleeves
undersoil	undersoils
undersong	undersongs
undersow	undersowing|undersowed|undersown|undersows
underspend	underspending|underspends|underspent
understaffing	understaffings
understand	understanding|understood|understands
understate	understated|understating|understates
understeer	understeers|understeering|understeered
understock	understocking|understocks|understocked
understrapper	understrappers
understroke	understroking|understrokes|understroked
understudy	understudies|understudying|understudied
undersubscribe	undersubscribes|undersubscribing|undersubscribed
undersupply	undersupplying|undersupplied|undersupplies
undersurface	undersurfaces
undertake	undertakes|undertook|undertaken|undertaking
undertaker	undertakers
undertaking	undertakings
undertax	undertaxed|undertaxing|undertaxes
undertenancy	undertenancies
undertenant	undertenants
underthrust	underthrusted|underthrusting|underthrusts
undertime	undertiming|undertimed|undertimes
undertint	undertints
undertone	undertoning|undertones|undertoned
undertow	undertowed|undertows|undertowing
undertray	undertrays
underutilise	underutilised|underutilises|underutilising
underutilize	underutilized|underutilizing|underutilizes
undervalue	undervalues|undervalued|undervaluing
undervest	undervests
underwater	underwatered|underwatering|underwaters
underway	underways
underwing	underwings
underwit	underwits
underworking	underworkings
underworld	underworlds
underwrite	underwrote|underwrites|underwritten|underwriting
underwriter	underwriters
underwriting	underwritings
undesirable	undesirables
undine	undines
undo	undoing|undoes|undid|undos|undone
undoable	undoables
undocking	undockings
undocumented	undocumenteds
undoer	undoers
undoing	undoings
undouble	undoubling|undoubled|undoubles
undraw	undrawn|undrew|undraws|undrawing
undress	undresses|undressed|undressing
undulate	undulating|undulated|undulates
undulating	undulatings
unearthliness	unearthlinesses
unearthly	unearthliest|unearthlier
unease	uneasing|uneased|uneases
uneasy	uneasiest|uneasier
unedge	unedging|unedged|unedges
unelectable	unelectables
unemployable	unemployables
unequal	unequals
unerase	unerased|unerasing|unerases
unface	unfaced|unfaces|unfacing
unfair	unfairer|unfairest
unfamiliar	unfamiliars
unfavourite	unfavouriting|unfavourited|unfavourites
unfed	unfeds
unfence	unfenced|unfencing|unfences
unfeudalize	unfeudalizing|unfeudalizes|unfeudalized
unfile	unfiled|unfiles|unfiling
unfit	unfitter|unfitted|unfits|unfitting|unfittest
unfix	unfixing|unfixed|unfixes
unfold	unfolding|unfolded|unfolds
unfolding	unfoldings
unforeseen	unforeseens
unfortunate	unfortunates
unframe	unframing|unframes|unframed
unfreeze	unfrozen|unfroze|unfreezing|unfreezes
unfriendly	unfriendlies
unfunny	unfunniest|unfunnier
unfuse	unfused|unfusing|unfuses
unfussy	unfussier|unfussiest
ungag	ungagged|ungagging|ungags
ungainly	ungainlies
unget	ungetting|ungets|ungot
ungild	ungilding|ungilded|ungilds
ungirdle	ungirdles|ungirdling|ungirdled
unglue	unglues|unglued|ungluing
ungrateful	ungratefuls
unground	ungrounded|ungrounding|ungrounds
ungual	unguals
unguent	unguents
unguiculate	unguiculates
ungulate	ungulates
unguligrade	unguligrades
ungum	ungums|ungummed|ungumming
unhandy	unhandier|unhandiest
unhang	unhanging|unhangs|unhung
unhappy	unhappies
unharness	unharnessing|unharnessed|unharnesses
unhat	unhatted|unhats|unhatting
unhele	unheling|unheled|unheles
unhide	unhidden|unhid|unhiding|unhides
unhinge	unhinging|unhinges|unhinged
unhitch	unhitches|unhitched|unhitching
unhive	unhives|unhiving|unhived
unhooking	unhookings
unhopeful	unhopefuls
unhorse	unhorsing|unhorsed|unhorses
unhouse	unhouses|unhoused|unhousing
unhumanize	unhumanized|unhumanizes|unhumanizing
unicell	unicells
unicellular	unicellulars
unicorn	unicorned|unicorning|unicorns
unicursal	unicursals
unicycle	unicycled|unicycling|unicycles
unicyclist	unicyclists
unidirectional	unidirectionals
unifier	unifiers
unifoliate	unifoliates
uniform	uniforming|uniformed|uniforms
uniformise	uniformised|uniformising|uniformises
uniformize	uniformizing|uniformized|uniformizes
unify	unifying|unified|unifies
unilingual	unilinguals
uninitialize	uninitialized|uninitializes|uninitializing
uninstall	uninstalling|uninstalls|uninstalled
uninsurable	uninsurables
uninsured	uninsureds
unionisation	unionisations
unionise	unionising|unionised|unionises
unionist	unionists
unionization	unionizations
unionize	unionizing|unionizes|unionized
unionizer	unionizers
uniprocessor	uniprocessors
unique	uniques
uniselector	uniselectors
unisexual	unisexuals
unit	units
unitarian	unitarians
unitary	unitaries
unite	unites|uniting|united
unitholder	unitholders
unitize	unitizing|unitizes|unitized
univalent	univalents
univalve	univalves
universal	universals
universalise	universalises|universalised|universalising
universalist	universalists
universalize	universalizes|universalizing|universalized
universe	universes
universitarian	universitarians
university	universities
univocal	univocals
unkennel	unkennels|unkenneled|unkenneling
unknit	unknitting|unknitted|unknits
unknot	unknotting|unknotted|unknots
unknowable	unknowables
unknowing	unknowings
unknown	unknowns
unlace	unlaced|unlaces|unlacing
unlade	unlades|unlading|unladen|unladed
unlash	unlashes|unlashing|unlashed
unlatch	unlatching|unlatched|unlatches
unlay	unlaid|unlays|unlaying
unlearn	unlearned|unlearning|unlearns
unleash	unleashed|unleashes|unleashing
unlike	unliking|unliked|unlikes
unlikely	unlikelies
unline	unlines|unlined|unlining
unlink	unlinked|unlinks|unlinking
unlive	unlived|unlives|unliving
unloader	unloaders
unloading	unloadings
unlock	unlocking|unlocks|unlocked
unlocking	unlockings
unloose	unlooses|unloosing|unloosed
unloosen	unloosened|unloosens|unloosening
unlovely	unloveliest|unlovelier
unmake	unmakes|unmaking|unmade
unman	unmanned|unmanning|unmans
unmantle	unmantling|unmantled|unmantles
unmarried	unmarrieds
unmarry	unmarried|unmarries|unmarrying
unmentionable	unmentionables
unmixing	unmixings
unmuffle	unmuffled|unmuffling|unmuffles
unmuzzle	unmuzzling|unmuzzled|unmuzzles
unnaturalise	unnaturalised|unnaturalising|unnaturalises
unnaturalize	unnaturalized|unnaturalizes|unnaturalizing
unobservable	unobservables
unobtainable	unobtainables
unorthodoxy	unorthodoxies
unpacking	unpackings
unpalatable	unpalatables
unpeg	unpegging|unpegs|unpegged
unpen	unpenned|unpenning|unpens
unpeople	unpeoples|unpeopling|unpeopled
unperch	unperching|unperched|unperches
unpile	unpiles|unpiled|unpiling
unpin	unpinned|unpinning|unpins
unplait	unplaited|unplaits|unplaiting
unplug	unplugs|unplugging|unplugged
unpopularity	unpopularities
unpredictable	unpredictables
unprepared	unprepareds
unpretty	unpretties|unprettied|unprettying
unpreventable	unpreventables
unprintable	unprintables
unprofessional	unprofessionals
unpronounceable	unpronounceables
unprop	unprops|unpropping|unpropped
unpurse	unpursing|unpursed|unpurses
unpuzzle	unpuzzling|unpuzzled|unpuzzles
unqualify	unqualifies|unqualified|unqualifying
unquantifiable	unquantifiables
unquiet	unquieter|unquietest
unravel	unravelled|unravelling|unravels
unreachable	unreachables
unread	unreading|unreads
unreconcilable	unreconcilables
unreeve	unreeving|unreeves|unreeved
unrespectable	unrespectables
unriddle	unriddling|unriddles|unriddled
unriddler	unriddlers
unrig	unrigged|unrigging|unrigs
unring	unringing|unrings|unrung
unrip	unrips|unripping|unripped
unripe	unriper|unripest
unrobe	unrobes|unrobing|unrobed
unruly	unruliest|unrulier
unrumple	unrumpling|unrumples|unrumpled
unsaddle	unsaddles|unsaddling|unsaddled
unsafety	unsafetying|unsafeties|unsafetied
unsalable	unsalables
unsaleable	unsaleables
unsaturate	unsaturates
unsay	unsays|unsaying|unsaid
unscale	unscaled|unscales|unscaling
unscramble	unscrambled|unscrambles|unscrambling
unscrambler	unscramblers
unscrewing	unscrewings
unseemly	unseemlier|unseemliest
unseen	unseens
unset	unsetting|unsets
unsettle	unsettles|unsettled|unsettling
unsettling	unsettlings
unsew	unsewed|unsewing|unsewn|unsews
unsex	unsexed|unsexing|unsexes
unshackle	unshackling|unshackles|unshackled
unsheathe	unsheathing|unsheathes|unsheathed
unship	unshipping|unshipped|unships
unshoe	unshoed|unshoeing|unshoes
unshot	unshotting|unshotted|unshots
unshut	unshutting|unshuts
unsigned	unsigneds
unsling	unslinging|unslung|unslings
unsluice	unsluices|unsluicing|unsluiced
unsnap	unsnapped|unsnapping|unsnaps
unsnare	unsnares|unsnared|unsnaring
unsociable	unsociables
unsphere	unsphered|unsphering|unspheres
unsplit	unsplitting|unsplits
unstable	unstabling|unstables|unstabled
unstarch	unstarches|unstarched|unstarching
unstate	unstates|unstated|unstating
unsteady	unsteadies|unsteadied|unsteadying|unsteadier|unsteadiest
unstep	unstepped|unstepping|unsteps
unstick	unsticking|unstuck|unsticks
unstitch	unstitching|unstitched|unstitches
unstop	unstops|unstopped|unstopping
unstrap	unstrapping|unstraps|unstrapped
unstring	unstrung|unstrings|unstringing
unsubscribe	unsubscribing|unsubscribed|unsubscribes
unsure	unsurer|unsurest
unswaddle	unswaddles|unswaddling|unswaddled
unswathe	unswathing|unswathes|unswathed
unswear	unswore|unswears|unswearing|unsworn
untag	untags|untagged|untagging
untangle	untangles|untangling|untangled
untax	untaxes|untaxed|untaxing
unteach	untaught|unteaching|unteaches
unteachable	unteachables
unthrifty	unthriftier|unthriftiest
unthrone	unthroning|unthroned|unthrones
untidy	untidies|untidied|untidying|untidiest|untidier
untie	unties|untying|untied
untile	untiling|untiles|untiled
untin	untinned|untinning|untins
untouchable	untouchables
untranslatable	untranslatables
untread	untrod|untreads|untreading
untune	untuned|untunes|untuning
untwine	untwines|untwining|untwined
untwist	untwisted|untwisting|untwists
untwisting	untwistings
unusual	unusuals
unvoice	unvoicing|unvoiced|unvoices
unvote	unvoted|unvoting|unvotes
unwanted	unwanteds
unwary	unwarier|unwariest
unwearable	unwearables
unweary	unwearies|unwearying|unwearied
unweave	unweaving|unweaves|unwove|unwoven
unwed	unwedding|unweds
unwelcome	unwelcomes|unwelcomed|unwelcoming
unwieldy	unwieldier|unwieldiest
unwill	unwilled|unwilling|unwills
unwind	unwinds|unwinding|unwound
unwinder	unwinders
unwinding	unwindings
unwise	unwisest|unwiser
unworkable	unworkables
unworldly	unworldliest|unworldlier
unworthy	unworthies|unworthiest|unworthier
unwrap	unwrapping|unwrapped|unwraps
unwrinkle	unwrinkles|unwrinkled|unwrinkling
unyoke	unyokes|unyoking|unyoked
unzip	unzipped|unzipping|unzips
up	upping|ups|upped
upbear	upbearing|upbore|upborne|upbears
upbeat	upbeats
upbraider	upbraiders
upbraiding	upbraidings
upburst	upbursts
upcast	upcasts|upcasting
update	updating|updated|updates
updater	updaters
updating	updatings
updo	updos
upender	upenders
upflow	upflowed|upflowing|upflows
upfold	upfolded|upfolds|upfolding
upgrade	upgraded|upgrading|upgrades
upgrading	upgradings
upgrowth	upgrowths
upheave	upheaved|upheaving|upheaves
uphill	further|uphills|furthest
uphold	upheld|upholding|upholds
upholder	upholders
upholster	upholstering|upholstered|upholsters
upholsterer	upholsterers
upkeep	upkept|upkeeping|upkeeps
upland	uplands
uplander	uplanders
uplift	uplifting|uplifts|uplifted
uplink	uplinking|uplinks|uplinked
upload	uploaded|uploads|uploading
upper	uppers
uppercase	uppercased|uppercasing|uppercases
uppercut	uppercutting|uppercuts
uppity	uppitier|uppitiest
upraise	upraises|upraised|upraising
upright	uprighted|uprighting|uprights
uprisal	uprisals
uprise	uprose|uprisen|uprises|uprising
uprising	uprisings
upriver	further|furthest
uprooter	uprooters
uprooting	uprootings
uprush	uprushing|uprushed|uprushes
upscale	upscaled|upscaling|upscales
upset	upsets|upsetting
upsetter	upsetters
upsetting	upsettings
upshot	upshots
upside	upsides
upstage	upstages|upstaged|upstaging
upstager	upstagers
upstairs	further|furthest
upstart	upstarts|upstarting|upstarted
upstate	upstates
upstream	upstreaming|upstreams|upstreamed
upstroke	upstrokes
upsurge	upsurged|upsurging|upsurges
upswell	upswelled|upswelling|upswells
upswing	upswings|upswung|upswinging
uptake	uptakes|uptaken|uptaking|uptook
upthrow	upthrown|upthrows|upthrew|upthrowing
uptick	upticks
uptight	uptighter|uptightest|uptights
uptown	uptowns
uptowner	uptowners
uptrend	uptrended|uptrends|uptrending
upturn	upturns|upturned|upturning
upturning	upturnings
upwarp	upwarps
upwind	upwinds|upwinding|upwound
upwing	upwinging|upwinged|upwings
uranism	uranisms
uranoplasty	uranoplasties
urbanise	urbanised|urbanising|urbanises
urbanize	urbanized|urbanizes|urbanizing
urchin	urchins
ureameter	ureameters
ureter	ureters
ureterectomy	ureterectomies
ureterocele	ureteroceles
ureterocutaneostomy	ureterocutaneostomies
ureterolith	ureteroliths
ureterolithotomy	ureterolithotomies
ureterosigmoidostomy	ureterosigmoidostomies
ureterostomy	ureterostomies
ureterotomy	ureterotomies
ureteroureterostomy	ureteroureterostomies
urethrocele	urethroceles
urethropexy	urethropexies
urethroplasty	urethroplasties
urethroscope	urethroscopes
urethrostomy	urethrostomies
urethrotomy	urethrotomies
urge	urged|urges|urging
urinal	urinals
urinary	urinaries
urinate	urinates|urinating|urinated
urinator	urinators
urine	urined|urining|urines
urinometer	urinometers
urn	urned|urns|urning
urocele	uroceles
urocyst	urocysts
urogram	urograms
urolith	uroliths
urologist	urologists
uropathogen	uropathogens
uroscopy	uroscopies
urostealith	urostealiths
urotoxin	urotoxins
ursine	ursines
urticant	urticants
use	used|using|uses
user	users
usher	ushers|ushering|ushered
usherette	usherettes
usufruct	usufructed|usufructing|usufructs
usufructuary	usufructuaries
usurer	usurers
usurper	usurpers
ut	uts
utensil	utensils
uterine	uterines
util	utils
utile	utiles
utilise	utilising|utilises|utilised
utilitarian	utilitarians
utilize	utilizing|utilizes|utilized
utilizer	utilizers
utopian	utopians
utricle	utricles
utterance	utterances
utterer	utterers
uudecode	uudecoded|uudecoding|uudecodes
uuencode	uuencoded|uuencoding|uuencodes
uvea	uveas
uvular	uvulars
uvulectomy	uvulectomies
uvulotome	uvulotomes
uvulotomy	uvulotomies
vac	vacked|vacs|vacking
vaca	vacas
vacate	vacated|vacating|vacates
vacationer	vacationers
vacationist	vacationists
vaccinate	vaccinated|vaccinating|vaccinates
vaccinationist	vaccinationists
vaccinator	vaccinators
vacillate	vacillating|vacillates|vacillated
vacillating	vacillatings
vacillator	vacillators
vacuolate	vacuolating|vacuolates|vacuolated
vacuole	vacuoles
vacuome	vacuomes
vacuometer	vacuometers
vacuumize	vacuumized|vacuumizes|vacuumizing
vag	vagging|vagged|vags
vagabond	vagabonds|vagabonding|vagabonded
vagabondize	vagabondizing|vagabondized|vagabondizes
vagabondry	vagabondries
vagary	vagaries
vaginate	vaginates|vaginated|vaginating
vaginoscope	vaginoscopes
vaginoscopy	vaginoscopies
vagotomy	vagotomies
vagrant	vagrants
vagrom	vagroms
vague	vaguing|vagues|vaguer|vaguest|vagued
vainglory	vainglories|vainglorying|vaingloried
valance	valances
vale	vales
valediction	valedictions
valedictorian	valedictorians
valedictory	valedictories
valentine	valentines
valet	valeting|valeted|valets
valetudinarian	valetudinarians
valetudinary	valetudinaries
valiant	valiants
validate	validates|validating|validated
validator	validators
valise	valises
valley	valleys
valorise	valorising|valorised|valorises
valorization	valorizations
valorize	valorized|valorizes|valorizing
valse	valses
valuable	valuables
valuate	valuates|valuated|valuating
valuator	valuators
value	valuing|valued|values
valuer	valuers
valve	valving|valves|valved
valvelet	valvelets
valvotomy	valvotomies
valvulotomy	valvulotomies
vamoose	vamoosed|vamoosing|vamooses
vamose	vamosed|vamosing|vamoses
vamp	vamped|vamping|vamps
vamper	vampered|vampers|vampering
vampire	vampires|vampired|vampiring
vampy	vampier|vampiest
van	vanning|vanned|vans
vanadate	vanadates
vandal	vandals
vandalise	vandalised|vandalising|vandalises
vandalize	vandalized|vandalizing|vandalizes
vandyke	vandyking|vandykes|vandyked
vane	vanes
vanguard	vanguards
vanguardist	vanguardists
vanillin	vanillins
vanish	vanished|vanishes|vanishing
vanisher	vanishers
vanitory	vanitories
vanquish	vanquishing|vanquishes|vanquished
vanquisher	vanquishers
vantage	vantaged|vantages|vantaging
vanward	vanwards
vaporer	vaporers
vaporimeter	vaporimeters
vaporise	vaporised|vaporising|vaporises
vaporize	vaporizes|vaporized|vaporizing
vaporizer	vaporizers
vapourer	vapourers
vapouring	vapourings
var	vars
vara	varas
varactor	varactors
varan	varans
variable	variables
variant	variants
variate	variated|variating|variates
variator	variators
varicectomy	varicectomies
varicosity	varicosities
variegate	variegated|variegating|variegates
variegator	variegators
varietal	varietals
variolate	variolating|variolated|variolates
varioloid	varioloids
varistor	varistors
varlet	varlets
varment	varments
varmeter	varmeters
varmint	varmints
varnish	varnished|varnishes|varnishing
varnisher	varnishers
varnishing	varnishings
vary	varies|varied|varying
varying	varyings
vasa	vasas
vasal	vasals|vasalling|vasalled
vase	vases
vasectomy	vasectomies
vaseline	vaselined|vaselines|vaselining
vasodepressor	vasodepressors
vasomotion	vasomotions
vasopressor	vasopressors
vasotomy	vasotomies
vasotonic	vasotonics
vassal	vassals|vassalling|vassalled
vast	vasts
vasty	vastier|vastiest
vat	vatted|vats|vatting
vaticinate	vaticinating|vaticinated|vaticinates
vaticination	vaticinations
vaticinator	vaticinators
vaudevillist	vaudevillists
vault	vaulted|vaults|vaulting
vaulter	vaulters
vaunt	vaunting|vaunts|vaunted
vaunter	vaunters
vaunting	vauntings
vauquelinite	vauquelinites
vealer	vealers
vector	vectoring|vectors|vectored
vectorscope	vectorscopes
vedette	vedettes
vee	vees
veep	veeps
veer	veers|veered|veering
veering	veerings
veg	vegging|vegged|vegges|vegs
vega	vegas
vegan	vegans
vegetable	vegetables
vegetal	vegetals
vegetate	vegetated|vegetates|vegetating
vehicle	vehicles
vehiculate	vehiculates|vehiculated|vehiculating
veil	veils|veiled|veiling
vein	veining|veined|veins
veining	veinings
veinlet	veinlets
veiny	veiniest|veinier
velar	velars
veld	velds
veldt	veldts
veleta	veletas
vellicate	vellicates|vellicating|vellicated
vellication	vellications
velocimeter	velocimeters
velocipede	velocipeded|velocipeding|velocipedes
velocipedist	velocipedists
velodrome	velodromes
velopharyngeal	velopharyngeals
velure	velured|veluring|velures
vend	vends|vended|vending
vendee	vendees
vender	venders
vendetta	vendettas
vendible	vendibles
vendor	vendored|vendors|vendoring
vendue	vendues
veneerer	veneerers
veneering	veneerings
venerate	venerated|venerates|venerating
venerator	venerators
venereologist	venereologists
venerer	venerers
venge	venges|venged|venging
venger	vengers
venin	venins
venipuncture	venipunctures|venipuncturing|venipunctured
venotomy	venotomies
vent	vented|vents|venting
venta	ventas
ventage	ventages
venter	venters
ventiduct	ventiducts
ventilate	ventilated|ventilates|ventilating
ventilator	ventilators
venting	ventings
ventouse	ventoused|ventousing|ventouses
ventral	ventrals
ventriculostomy	ventriculostomies
ventriloquist	ventriloquists
ventriloquize	ventriloquized|ventriloquizes|ventriloquizing
venture	venturing|ventured|ventures
venturer	venturers
venue	venues
venule	venules
venus	venuses
veny	venies
veranda	verandas
verandah	verandahs
verb	verbed|verbs|verbing
verbal	verballed|verballing|verbals
verbalise	verbalises|verbalised|verbalising
verbalist	verbalists
verbalize	verbalizing|verbalized|verbalizes
verbalizer	verbalizers
verbarian	verbarians
verbatim	verbatims
verbena	verbenas
verberate	verberating|verberated|verberates
verberation	verberations
verbify	verbified|verbifies|verbifying
verbigerate	verbigerating|verbigerates|verbigerated
verdict	verdicts
verdigris	verdigrised|verdigrises|verdigrising
verdure	verdured|verdures|verduring
verge	verged|verging|verges
verger	vergers
verifiable	verifiables
verifier	verifiers
verify	verified|verifies|verifying
vermicide	vermicides
vermiculate	vermiculating|vermiculated|vermiculates
vermifuge	vermifuges
verminate	verminated|verminates|verminating
vernacular	vernaculars
vernacularise	vernacularises|vernacularised|vernacularising
vernacularize	vernacularizing|vernacularizes|vernacularized
vernalize	vernalized|vernalizing|vernalizes
vernicle	vernicles
vernier	verniers
vernissage	vernissages
veronica	veronicaing|veronicas|veronicaed
versant	versants
verse	versed|verses|versing
versemonger	versemongers
verset	versets
versicle	versicles
versificator	versificators
versifier	versifiers
versify	versified|versifies|versifying
versionist	versionists
verso	versos
verst	versts
vert	verts
vertebral	vertebrals
vertebrate	vertebrates
vertical	verticals
verticel	verticels
verticil	verticils
vertiginate	vertiginating|vertiginates|vertiginated
vesicant	vesicants
vesicate	vesicates|vesicated|vesicating
vesicatory	vesicatories
vesicle	vesicles
vesicocele	vesicoceles
vesiculate	vesiculating|vesiculated|vesiculates
vesiculectomy	vesiculectomies
vesper	vespers
vespiary	vespiaries
vessel	vessels|vesselled|vesselling
vest	vesting|vests|vested
vesta	vestas
vestal	vestals
vestee	vestees
vestiary	vestiaries
vestibular	vestibulars
vestibule	vestibuling|vestibuled|vestibules
vestibuloplasty	vestibuloplasties
vestige	vestiges
vestigial	vestigials
vestment	vestments
vestry	vestries
vesture	vestures|vesturing|vestured
vet	vets|vetted|vetting
vetch	vetches
veteran	veterans
veterinarian	veterinarians
veterinary	veterinaries
veto	vetoes|vetoing|vetoed
vetoer	vetoers
vetting	vettings
vex	vexed|vexes|vexing
vexer	vexers
viable	viables
viaduct	viaducts
vial	vialling|vials|vialled
viameter	viameters
viand	viands
vibraphone	vibraphones
vibraphonist	vibraphonists
vibrate	vibrates|vibrating|vibrated
vibrato	vibratos
vibrator	vibrators
vibrio	vibrios
vibrion	vibrions
vibrograph	vibrographs
vibrometer	vibrometers
vibroscope	vibroscopes
vic	vics
vicar	vicars
vicaress	vicaresses
vicarian	vicarians
vicariate	vicariates
vice	vicing|vices|viced
vicegerency	vicegerencies
vicegerent	vicegerents
viceregal	viceregals
vicereine	vicereines
viceroy	viceroys
vicinage	vicinages
vicissitude	vicissitudes
victim	victims
victimisation	victimisations
victimise	victimising|victimised|victimises
victimize	victimized|victimizes|victimizing
victimizer	victimizers
victor	victors
victoria	victorias
victory	victoried|victorying|victories
victress	victresses
victual	victualing|victualed|victuals
victualler	victuallers
vicuna	vicunas
vide	viding|vides|vided
video	videoes|videoed|videoing
videoconference	videoconferenced|videoconferences|videoconferencing
videodisc	videodiscs
videodisk	videodisks
videotape	videotaping|videotapes|videotaped
videotaping	videotapings
vidette	videttes
vidicon	vidicons
vidimus	vidimuses
vie	vies|vied|vying
view	views|viewing|viewed
viewer	viewers
viewfinder	viewfinders
viewing	viewings
viewport	viewported|viewporting|viewports
viewy	viewiest|viewier
vigesimal	vigesimals
vigia	vigias
vigil	vigils
vigilante	vigilantes
vigilantism	vigilantisms
vigneron	vignerons
vignette	vignetted|vignetting|vignettes
vignetter	vignetters
vignettist	vignettists
vigoroso	vigorosos
viking	vikings
vilifier	vilifiers
vilify	vilifying|vilifies|vilified
vill	vills
village	villages
villager	villagers
villainess	villainesses
villakin	villakins
villan	villans
villein	villeins
villosity	villosities
vina	vinas
vindicate	vindicated|vindicating|vindicates
vindicator	vindicators
vinedresser	vinedressers
vinegarette	vinegarettes
vinegrower	vinegrowers
viner	viners
vinery	vineries
vineyard	vineyards
viniculturist	viniculturists
vintage	vintaged|vintaging|vintages
vintager	vintagers
vintaging	vintagings
vintner	vintners
vintry	vintries
viny	viniest|vinier
vinylation	vinylations
viol	violing|viols|violed
viola	violas
violate	violated|violating|violates
violator	violators
violence	violencing|violences|violenced
violent	violents|violented|violenting
violet	violeter|violets|violetest
violin	violining|violins|violined
violinist	violinists
violist	violists
violoncellist	violoncellists
viper	vipers
viraemia	viraemias
viral	virals
virelay	virelays
virement	virements
virgin	virgins
virgule	virgules
viricide	viricides
virid	virids
viridity	viridities
virologist	virologists
virtual	virtuals
visa	visaed|visas|visaing
visage	visages
visard	visarded|visards|visarding
viscerate	viscerates|viscerated|viscerating
viscoelastic	viscoelastics
viscometer	viscometers
viscosimeter	viscosimeters
viscountcy	viscountcies
viscountess	viscountesses
viscountship	viscountships
viscounty	viscounties
vise	vising|vised|vises
visionary	visionaries
visionist	visionists
visit	visited|visits|visiting
visitant	visitants
visite	visites
visiting	visitings
visitor	visitors
visitress	visitresses
visne	visnes
vison	visons
visor	visors
vista	vistas|vistaing|vistaed
visual	visuals
visualise	visualises|visualising|visualised
visualize	visualizing|visualizes|visualized
visualizer	visualizers
visé	visés|viséing|viséed
vitalise	vitalises|vitalising|vitalised
vitalist	vitalists
vitalize	vitalizes|vitalizing|vitalized
vitalizer	vitalizers
vitamer	vitamers
vitamin	vitamins
vitamine	vitamines
vitaminise	vitaminises|vitaminising|vitaminised
vitaminize	vitaminizing|vitaminized|vitaminizes
vitiate	vitiating|vitiated|vitiates
vitiator	vitiators
viticulturist	viticulturists
vitrail	vitrails
vitrectomy	vitrectomies
vitrify	vitrifying|vitrified|vitrifies
vitrine	vitrines
vitriol	vitrioled|vitriols|vitrioling
vitriolise	vitriolises|vitriolised|vitriolising
vitriolize	vitriolizes|vitriolizing|vitriolized
vituperate	vituperating|vituperates|vituperated
vituperator	vituperators
viva	vivaed|vivaing|vivas
vivary	vivaries
vivat	vivats
vivid	vividest|vivids|vivider
vivifier	vivifiers
vivify	vivified|vivifying|vivifies
vivisectionist	vivisectionists
vivisector	vivisectors
vixen	vixens
vizard	vizards
vizier	viziers
vizierate	vizierates
vizir	vizirs
vizor	vizors
vocable	vocables
vocal	vocals
vocalise	vocalises|vocalising|vocalised
vocalism	vocalisms
vocalist	vocalists
vocalize	vocalized|vocalizing|vocalizes
vocalizer	vocalizers
vocative	vocatives
vociferate	vociferating|vociferates|vociferated
vociferation	vociferations
vociferator	vociferators
vogue	vogued|vogues|voguing
voice	voiced|voices|voicing
voicer	voicers
void	voided|voids|voiding
voider	voiders
voiding	voidings
vol	vols
volary	volaries
volatile	volatiles
volatilise	volatilised|volatilising|volatilises
volatilize	volatilizes|volatilized|volatilizing
volatilizer	volatilizers
volborthite	volborthites
volcanic	volcanics
volcanist	volcanists
volcanologist	volcanologists
vole	voles|voled|voling
volery	voleries
volley	volleys|volleying|volleyed
volleyballer	volleyballers
volleyer	volleyers
volplane	volplaned|volplaning|volplanes
volt	volts
voltameter	voltameters
voltammeter	voltammeters
voltmeter	voltmeters
volume	volumed|voluming|volumes
volumenometer	volumenometers
volumeter	volumeters
voluntarist	voluntarists
voluntary	voluntaries
voluntaryist	voluntaryists
voluntative	voluntatives
volunteer	volunteering|volunteers|volunteered
voluptuary	voluptuaries
volution	volutions
vomer	vomers
vomiter	vomiters
vomitive	vomitives
vomitory	vomitories
voodooist	voodooists
vorticist	vorticists
votaress	votaresses
votarist	votarists
votary	votaries
votator	votators
vote	votes|voting|voted
voter	voters
voting	votings
votive	votives
vouch	vouches|vouched|vouching
vouchee	vouchees
voucher	vouchering|vouchered|vouchers
vouchsafe	vouchsafes|vouchsafing|vouchsafed
vow	vows|vowing|vowed
vowel	vowelled|vowelling|vowels
vowelise	vowelising|vowelises|vowelised
vowelization	vowelizations
vowelize	vowelizing|vowelizes|vowelized
vower	vowers
vox	voxes
voyage	voyaging|voyaged|voyages
voyager	voyagers
voyageur	voyageurs
voyeur	voyeurs
vugg	vuggs
vulcanise	vulcanising|vulcanised|vulcanises
vulcanism	vulcanisms
vulcanizate	vulcanizates
vulcanize	vulcanized|vulcanizing|vulcanizes
vulcanizer	vulcanizers
vulcanologist	vulcanologists
vulgar	vulgars
vulgarian	vulgarians
vulgarise	vulgarised|vulgarising|vulgarises
vulgarism	vulgarisms
vulgarity	vulgarities
vulgarize	vulgarizing|vulgarizes|vulgarized
vulgarizer	vulgarizers
vulgate	vulgated|vulgates|vulgating
vulnerary	vulneraries
vulpine	vulpines
vulture	vultured|vulturing|vultures
vulvectomy	vulvectomies
vum	vummed|vums|vumming
vying	vyings
wabble	wabbled|wabbling|wabbles
wabbling	wabblings
wacky	wackiest|wackier
wad	wadding|wadded|wads
waddle	waddling|waddled|waddles
waddling	waddlings
waddy	waddies|waddied|waddying
wade	wades|wading|waded
wader	waders
wafer	wafering|wafered|wafers
waffle	waffling|waffled|waffles
waft	wafted|wafts|wafting
wag	wagging|wagged|wags
wage	waged|wages|waging
wager	wagering|wagered|wagers
wagerer	wagerers
wageworker	wageworkers
waggle	waggled|waggling|waggles
waggly	waggliest|wagglier
waggon	waggoned|waggons|waggoning
waggoner	waggoners
waggonette	waggonettes
wagon	wagoning|wagons|wagoned
wagoner	wagoners
wagonette	wagonettes
wagonload	wagonloads
wagtail	wagtails
waif	waifs
wail	wails|wailed|wailing
wailer	wailers
wailing	wailings
wainscot	wainscotting|wainscotted|wainscots
waist	waists
waistband	waistbands
waistcoat	waistcoats
wait	waits|waited|waiting
waitress	waitressing|waitressed|waitresses
waive	waives|waiving|waived
waiver	waivers|waivering|waivered
wake	woken|woke|waking|wakes
wakener	wakeners
wakening	wakenings
wale	waled|wales|waling
waling	walings
walk	walking|walks|walked
walkabout	walkabouts
walkaway	walkaways
walker	walkers
walkout	walkouts
walkway	walkways
wall	walling|walled|walls
walla	wallas
wallaby	wallabies
wallah	wallahs
waller	wallering|wallered|wallers
wallet	wallets
wallflower	wallflowers|wallflowering|wallflowered
wallop	walloping|wallops|walloped
walloping	wallopings
wallow	wallowed|wallowing|wallows
wally	wallies
waltz	waltzing|waltzed|waltzes
wamble	wambling|wambles|wambled
wampee	wampees
wamus	wamuses
wan	wanner|wannest
wand	wanded|wanding|wands
wanderer	wanderers
wandering	wanderings
wane	waned|waning|wanes
wangle	wangled|wangles|wangling
wangler	wanglers
wangling	wanglings
wanker	wankers
wanting	wantings
wanton	wantonest|wantoning|wantoned|wantons|wantoner
wapentake	wapentakes
war	warring|warred|wars
warbird	warbirds
warble	warbles|warbled|warbling
warbler	warblers
ward	warded|warding|wards
warden	wardened|wardening|wardens
wardenship	wardenships
warder	warders
warding	wardings
wardress	wardresses
wardrobe	wardrobing|wardrobed|wardrobes
wardroom	wardrooms
ware	wared|wares|waring
warehouse	warehoused|warehousing|warehouses
warehousing	warehousings
warfare	warfaring|warfared|warfares
warhead	warheads
warlock	warlocks
warm	warmed|warmer|warmest|warms|warming
warmer	warmers
warming	warmings
warmonger	warmongering|warmongers|warmongered
warner	warners
warning	warnings
warper	warpers
warping	warpings
warragal	warragals
warrantee	warrantees
warranter	warranters
warrantor	warrantors
warranty	warranties|warrantied|warrantying
warren	warrens
warrener	warreners
warrigal	warrigals
warring	warrings
warrior	warriors
warship	warships
wart	warts
wary	wariest|warier
wash	washes|washed|washing
washable	washables
washboard	washboards|washboarding|washboarded
washday	washdays
washer	washers|washered|washering
washery	washeries
washout	washouts
washrag	washrags
washy	washier|washiest|washies
wasp	wasps
waspy	waspiest|waspier
wassailer	wassailers
wassailing	wassailings
wast	wasts
waste	wasting|wastes|wasted
wasteland	wastelands
waster	wasters
wasty	wastier|wastiest
watch	watching|watched|watches
watchdog	watchdogs|watchdogged|watchdogging
watcher	watchers
watching	watchings
watchword	watchwords
waterage	waterages
waterboy	waterboys
waterbus	waterbuses
watercourse	watercourses
waterer	waterers
waterfall	waterfalling|waterfalled|waterfalls
waterfront	waterfronts
watering	waterings
waterlog	waterlogging|waterlogs|waterlogged
watermain	watermains
watermark	watermarking|watermarks|watermarked
waterplane	waterplanes
waterproof	waterproofed|waterproofs|waterproofing
waterside	watersides
waterskier	waterskiers
waterspout	waterspouts
watery	wateriest|waterier
watt	watts
wattle	wattles|wattling|wattled
wattmeter	wattmeters
wave	waves|waved|waving
waveband	wavebands
waveform	waveforms
wavefront	wavefronts
waveguide	waveguided|waveguiding|waveguides
wavelength	wavelengths
wavemeter	wavemeters
waver	wavering|wavers|wavered
waverer	waverers
wavering	waverings
waving	wavings
wavy	waviest|wavier|wavies
wax	waxing|waxed|waxes
waxwork	waxworks
way	waying|ways|wayed
waybill	waybills|waybilled|waybilling
wayfare	wayfares|wayfaren|wayfaring|wayfore
wayfarer	wayfarers
waylay	waylays|waylaid|waylaying
wayleave	wayleaves
waypost	wayposts
wayside	waysides
wayzgoose	wayzgooses
wazir	wazirs
weak	weaker|weakest
weakling	weaklings
weakly	weakliest|weaklier
weal	wealed|weals|wealing
wean	weaned|weans|weaning
weanling	weanlings
weapon	weapons
weaponeer	weaponeering|weaponeered|weaponeers
wear	wears|wearing|worn|wore
wearable	wearables
wearer	wearers
wearing	wearings
wearout	wearouts
weary	weariest|wearying|wearied|wearies|wearier
weasand	weasands
weasel	weaseled|weaseling|weasels
weathercock	weathercocked|weathercocking|weathercocks
weatherometer	weatherometers
weave	weaving|woven|wove|weaves
weaver	weavers
weazen	weazens
web	webs|webbed|webbing
webby	webbiest|webbier
weber	webers
webhead	webheads
webmaster	webmasters
webmistress	webmistresses
webster	websters
wed	weds|wedding|wedded
wedding	weddings
wedge	wedges|wedging|wedged
wedgy	wedgiest|wedgier
wee	wees|weeing|weer|weest|weed
weed	weeds|weeded|weeding
weeder	weeders
weedhead	weedheads
weeding	weedings
weedy	weedier|weediest
week	weeks
weekday	weekdays
weekend	weekends|weekended|weekending
weekender	weekenders
weekly	weeklies
ween	weening|weened|weens
weeny	weenies|weenier|weeniest
weep	weeping|wept|weeps
weeper	weepers
weepy	weepiest|weepies|weepier
weevil	weevils
weft	wefts
weighbridge	weighbridges
weigher	weighers
weighing	weighings
weighting	weightings
weightometer	weightometers
weighty	weightier|weightiest
weir	weirs
weird	weirds|weirding|weirder|weirdest|weirded
weirdie	weirdies
welch	welches|welching|welched
welcome	welcomed|welcoming|welcomes
welcomer	welcomers
weld	welds|welding|welded
welder	welders
welding	weldings
weldment	weldments
welfare	welfaring|welfared|welfares
welfarist	welfarists
welkin	welkins
well	better|wells|welling|best|welled
welladay	welladays
wellington	wellingtons
wellingtonia	wellingtonias
welsh	welshes|welshed|welshing
welsher	welshers
welt	welted|welting|welts
welter	weltered|welters|weltering
welterweight	welterweights
wen	wens
wench	wenching|wenched|wenches
wend	wends|wended|wending
went	wents
wester	westered|westering|westers
westerly	westerlies
western	westerns
westerner	westerners
westernise	westernising|westernised|westernises
westernize	westernizing|westernizes|westernized
westing	westings
westwork	westworks
wet	wetter|wetting|wettest|wets
wether	wethers|wethering|wethered
wetting	wettings
whack	whacks|whackest|whacking|whacker|whacked
whacker	whackers
whacking	whackings
whale	whaled|whaling|whales
whaler	whalers
wham	whammed|whamming|whams
whang	whangs|whanging|whanged
wharfinger	wharfingers
whatnot	whatnots
wheal	wheals|whealed|whealing
wheatear	wheatears
wheedle	wheedled|wheedling|wheedles
wheedler	wheedlers
wheel	wheeled|wheeling|wheels
wheelbarrow	wheelbarrows|wheelbarrowing|wheelbarrowed
wheelbase	wheelbases
wheelchair	wheelchairs
wheeler	wheelers
wheelie	wheelying|wheelies|wheelied
wheeling	wheelings
wheelset	wheelsets
wheelwright	wheelwrights
wheen	wheens
wheeze	wheezed|wheezing|wheezes
wheezing	wheezings
wheezy	wheeziest|wheezier
whelk	whelks
whelm	whelms|whelmed|whelming
whelp	whelps|whelped|whelping
when	whens
where	wheres
whereas	whereases
wherefore	wherefores
whet	whets|whetted|whetting
whetstone	whetstones
whetting	whettings
which	whiches
whiff	whiffed|whiffs|whiffing
whiffet	whiffets
whiffle	whiffling|whiffled|whiffles
whig	whigged|whigs|whigging
while	whiles|whiling|whiled
whim	whimming|whims|whimmed
whimper	whimpers|whimpered|whimpering
whimperer	whimperers
whimpering	whimperings
whimsy	whimsying|whimsied|whimsies
whine	whined|whines|whining
whining	whinings
whinny	whinnying|whinnies|whinnied
whip	whips|whipped|whipping
whiplash	whiplashes|whiplashed|whiplashing
whipper	whippers
whippet	whippets
whippy	whippiest|whippier
whipray	whiprays
whipsaw	whipsaws|whipsawing|whipsawed|whipsawn
whipster	whipsters
whipstitch	whipstitching|whipstitched|whipstitches
whipstock	whipstocks
whir	whirs|whirring|whirred
whirl	whirling|whirls|whirled
whirligig	whirligigs
whirling	whirlings
whirlpool	whirlpooled|whirlpooling|whirlpools
whirlwind	whirlwinds
whirlybird	whirlybirds
whirr	whirring|whirrs|whirred
whish	whished|whishes|whishing
whisk	whisked|whisking|whisks
whisker	whiskers
whisper	whispered|whispers|whispering
whisperer	whisperers
whispering	whisperings
whistle	whistles|whistling|whistled
whistleblower	whistleblowers
whistling	whistlings
whit	whits
white	whites|whitest|whiter|whiting|whited
whitecap	whitecaps
whitesmith	whitesmiths
whitethorn	whitethorns
whitewash	whitewashing|whitewashes|whitewashed
whitewasher	whitewashers
whitewashing	whitewashings
whitey	whitier|whitiest
whitlow	whitlows
whittle	whittling|whittles|whittled
whittling	whittlings
whity	whitiest|whitier|whities
whiz	whizzing|whizzed|whizzes
whizz	whizzing|whizzed|whizzes
whizzer	whizzers
who	whos
whodunit	whodunits
whodunnit	whodunnits
whois	whoising|whoised|whoises
whole	wholes
wholesale	wholesales|wholesaling|wholesaled
wholesome	wholesomest|wholesomer
whoop	whooped|whoops|whooping
whoopee	whoopees|whoopeed|whoopeeing
whop	whopped|whops|whopping
whopper	whoppers
whopping	whoppings
whore	whored|whoring|whores
whorehouse	whorehouses
whoremaster	whoremasters
whoremonger	whoremongers
whoreson	whoresons
whorl	whorling|whorls|whorled
why	whys
wick	wicking|wicked|wicks
wicket	wickets
wicking	wickings
widder	widders
wide	widest|wides|wider
widening	widenings
widgeon	widgeons
widow	widowed|widowing|widows
widower	widowers
wieldy	wieldier|wieldiest
wifely	wifelier|wifeliest
wig	wigged|wigs|wigging
wigeon	wigeons
wigging	wiggings
wiggle	wiggles|wiggling|wiggled
wiggly	wiggliest|wigglier
wight	wights
wigwag	wigwagged|wigwagging|wigwags
wigwam	wigwams|wigwamming|wigwammed
wild	wilder|wilding|wilded|wildest|wilds
wildcat	wild|wildcatted|wildcatting|wildcats
wildcatter	wildcatters
wilding	wildings
wile	wiles|wiled|wiling
will	wills
willet	willets
willing	willings
willowy	willowier|willowiest
wimble	wimbles|wimbling|wimbled
wimp	wimps|wimped|wimping
wimple	wimpled|wimples|wimpling
win	won|winning|wins
wince	wincing|winces|winced
winch	winching|winches|winched
wind	winded|winding|winds
windbag	windbags
windbill	windbills
windbreaker	windbreakers
winder	windered|windering|winders
windfall	windfalls
windhover	windhovers
windlass	windlassing|windlassed|windlasses
windless	windlesses
windmill	windmills|windmilling|windmilled
windpipe	windpipes
windrow	windrowed|windrowing|windrows
windscreen	windscreening|windscreened|windscreens
windshield	windshielding|windshielded|windshields
windstorm	windstorms
windsurfer	windsurfers
windway	windways
windy	windier|windiest|windies
wine	wining|wined|wines
winebag	winebags
winebibber	winebibbers
wineglass	wineglasses
winepress	winepresses
winery	wineries
wineskin	wineskins
wing	winged|winging|wings
wingding	wingdings
winger	wingers
winglet	winglets
wingnut	wingnuts
wingy	wingies
wink	winked|winks|winking
winker	winkers
winking	winkings
winkle	winkled|winkling|winkles
winner	winners
winning	winnings
winnow	winnowing|winnows|winnowed
winnower	winnowers
winnowing	winnowings
wino	winos
winsome	winsomer|winsomest
wintering	winterings
winterise	winterising|winterised|winterises
winterize	winterized|winterizes|winterizing
wintertime	wintertimes
wintery	winteriest|winterier
wintry	wintriest|wintrier
winy	winiest|winier
winze	winzes
wipe	wiped|wipes|wiping
wiper	wipers
wiping	wipings
wire	wiring|wired|wires
wiredraw	wiredrew|wiredrawing|wiredraws|wiredrawn
wiredrawer	wiredrawers
wiredrawing	wiredrawings
wireless	wirelessing|wirelesses|wirelessed
wirephoto	wirephotos
wirepuller	wirepullers
wiretapper	wiretappers
wiry	wiriest|wirier
wise	wises|wised|wising
wiseacre	wiseacres
wisecrack	wisecracked|wisecracking|wisecracks
wisehead	wiseheads
wish	wished|wishing|wishes
wishbone	wishbones
wisher	wishers
wishing	wishings
wispy	wispier|wispiest
wistaria	wistarias
witch	witched|witches|witching
witching	witchings
wite	wited|wites|witing
with	withs
withdraw	withdrawn|withdrawing|withdrew|withdraws
withdrawer	withdrawers
withdrawing	withdrawings
withe	withes|withing|withed
wither	withered|withers|withering
withering	witherings
withhold	withheld|withholding|withholds
withstand	withstood|withstands|withstanding
withy	withier|withies|withiest
witness	witnessed|witnessing|witnesses
witticism	witticisms
witty	wittiest|wittier
wive	wives|wiving|wived
wivern	wiverns
wizard	wizarding|wizarded|wizards
wizier	wiziers
wobble	wobbles|wobbling|wobbled
wobbler	wobblers
wobbling	wobblings
wobbly	wobblies|wobbliest|wobblier
wobbulator	wobbulators
wodge	wodges
woeful	woefuller|woefullest
wok	wokked|wokking|woks
wold	wolder|woldest|wolds
wolf	wolfing|wolfs|wolfed|wolves
wolframate	wolframates
wolverene	wolverenes
wolverine	wolverines
womanise	womanised|womanises|womanising
womaniser	womanisers
womanize	womanized|womanizing|womanizes
womanizer	womanizers
womanly	womanlier|womanliest
womb	wombs|wombing|wombed
wombat	wombats
wondering	wonderings
wonderland	wonderlands
wonky	wonkiest|wonkier
woo	wooing|woos|wooed
wood	woodest|woods|wooding|wooder|wooded
woodbind	woodbinds
woodchuck	woodchucks
woodcutter	woodcutters
woodlander	woodlanders
woodpile	woodpiles
woodshed	woodshedded|woodsheds|woodshedding
woodside	woodsides
woodsy	woodsier|woodsiest
woodwind	woodwinds
woodworker	woodworkers
woody	woodier|woodiest|woodies
wooer	wooers
woof	woofed|woofing|woofs
woofer	woofers
wooing	wooings
woollen	woollens
woolly	woolliest|woollies|woollier
woolsack	woolsacks
woozy	woozier|wooziest
wop	wops
wordy	wordiest|wordier
work	worked|working|works
workaholic	workaholics
workbench	workbenches
workbook	workbooks
workday	workdays
worker	workers
workflow	workflows
workgroup	workgroups
workhouse	workhouses
workload	workloads
workout	workouts
workover	workovers
workpiece	workpieces
workroom	workrooms
worksheet	worksheeted|worksheeting|worksheets
workshop	workshopped|workshopping|workshops
worldling	worldlings
worm	worming|wormed|worms
wormy	wormier|wormiest
worrier	worriers
worry	worries|worried|worrying
worrying	worryings
worse	worsed|worsing|worses
worship	worships|worshipped|worshipping
worshiper	worshipers
worshipful	worshipfuls
worshipper	worshippers
wort	worts
worth	worthing|worths
worthy	worthier|worthies|worthiest|worthied|worthying
would	woulds
wound	wounds|wounding|wounded
woven	wovens
wow	wows|wowing|wowed
wowser	wowsers
wrack	wracked|wracking|wracks
wraith	wraiths
wrangle	wrangling|wrangles|wrangled
wrangler	wranglers
wrap	wraps|wrapping|wrapped
wrapper	wrappers
wrapping	wrappings
wrapround	wraprounds
wrasse	wrasses
wreak	wreaked|wreaking|wreaks
wreath	wreaths|wreathed|wreathing
wreathe	wreathes|wreathed|wreathing
wreck	wrecked|wrecks|wrecking
wrecker	wreckers
wrecking	wreckings
wren	wrens
wrench	wrenching|wrenched|wrenches
wrest	wresting|wrests|wrested
wrestle	wrestling|wrestles|wrestled
wrestler	wrestlers
wretch	wretched|wretches|wretching
wrick	wricked|wricking|wricks
wriggle	wriggles|wriggling|wriggled
wriggler	wrigglers
wright	wrighted|wrighting|wrights
wring	wrings|wrung|wringing
wringer	wringers
wringing	wringings
wrinkle	wrinkled|wrinkling|wrinkles
wrinkling	wrinklings
wrinkly	wrinklies|wrinkliest|wrinklier
wrist	wristed|wristing|wrists
wristband	wristbands
wristlet	wristlets
write	writing|wrote|written|writes
writer	writers
writhe	writhes|writhing|writhed
wrong	wrongs|wronging|wronged
wrongdoer	wrongdoers
wry	wried|wries|wrying
wryneck	wrynecks
wyandotte	wyandottes
wye	wyes
wynd	wynds
wyvern	wyverns
xanthine	xanthines
xebec	xebecs
xenoblast	xenoblasts
xenocryst	xenocrysts
xenograft	xenografted|xenografting|xenografts
xenomorph	xenomorphs
xenoparasite	xenoparasites
xenophobe	xenophobes
xenophobic	xenophobics
xerocopy	xerocopied|xerocopying|xerocopies
xerogel	xerogels
xerograph	xerographs
xerophagy	xerophagies
xerophthalmia	xerophthalmias
xerophyte	xerophytes
xerox	xeroxing|xeroxed|xeroxes
xi	xis
xiphoid	xiphoids
xylem	xylems
xylene	xylenes
xylocarp	xylocarps
xylographer	xylographers
xylol	xylols
xylolite	xylolites
xylophone	xylophones|xylophoned|xylophoning
xyster	xysters
yacht	yachted|yachts|yachting
yack	yacking|yacked|yacks
yaffle	yaffled|yaffles|yaffling
yah	yahs
yahoo	yahoos|yahooed|yahooing
yak	yakked|yaks|yakking
yale	yales
yam	yams
yang	yangs|yanged|yanging
yank	yanks|yanked|yanking
yankee	yankees
yap	yapping|yaps|yapped
yard	yarded|yards|yarding
yardage	yardages
yardarm	yardarms
yarder	yarders
yardstick	yardsticks
yarmulka	yarmulkas
yarovize	yarovized|yarovizes|yarovizing
yashmak	yashmaks
yataghan	yataghans
yaw	yawed|yawing|yaws
yawl	yawling|yawls|yawled
yawn	yawned|yawns|yawning
yawner	yawners
yawny	yawnier|yawniest
ye	yeyn
yea	yeas
yeah	yeahs
yeanling	yeanlings
year	years
yearling	yearlings
yearly	yearlies
yearn	yearns|yearned|yearning
yearning	yearnings
yeasty	yeastier|yeastiest
yegg	yeggs
yelk	yelks
yell	yells|yelling|yelled
yellow	yellowing|yellowest|yellower|yellowed|yellows
yellowback	yellowbacks
yellowing	yellowings
yellowy	yellowiest|yellowier
yelp	yelping|yelped|yelps
yen	yenning|yens|yenned
yeomanry	yeomanries
yes	yessing|yessed|yeses
yesterday	yesterdays
yesternight	yesternights
yestreen	yestreens
yet	yetted|yetting|yets
yield	yielded|yielding|yields
yielding	yieldings
yip	yips|yipping|yipped
yob	yobs
yodel	yodelling|yodelled|yodels
yogi	yogis|yogied
yoke	yoking|yokes|yoked
yokefellow	yokefellows
yokel	yokels
yokemate	yokemates
yolksac	yolksacs
yolky	yolkiest|yolkier
yomp	yomping|yomped|yomps
yonder	yonders
yoop	yoops
young	younger|youngest
younger	youngers
youngling	younglings
youngster	youngsters
younker	younkers
yowl	yowls|yowled|yowling
yoyo	yoyoed|yoyoing|yoyos
yucca	yuccas
yuck	yucked|yucks|yucking
yucky	yuckier|yuckiest
yummy	yummies|yummiest|yummier
zaire	zaires
zany	zanying|zanies|zaniest|zanier|zanied
zap	zapping|zaps|zapped
zappy	zappier|zappiest
zealot	zealots
zebu	zebus
zed	zedding|zedded|zeds
zee	zeed|zees|zeeing
zemindar	zemindars
zenana	zenanas
zenith	zeniths
zephyr	zephyred|zephyring|zephyrs
zeppelin	zeppelins
zero	zeroes|zeroed|zeroing
zeroing	zeroings
zeroize	zeroizes|zeroized|zeroizing
zest	zesting|zests|zested
zeta	zetas
zibet	zibets
zigger	ziggers
zigzag	zigzagged|zigzagging|zigzags
zigzagging	zigzaggings
zillion	zillions
zillionaire	zillionaires
zinc	zincing|zinced|zincs
zincify	zincifying|zincifies|zincified
zinco	zincos
zincograph	zincographs
zincographer	zincographers
zinnia	zinnias
zion	zions
zionist	zionists
zip	zipping|zipped|zips
zipper	zippers|zippering|zippered
zippy	zippiest|zippier
zircaloy	zircaloys
zirconyl	zirconyls
zither	zithers|zithering|zithered
zithern	zitherns
zodiac	zodiacs
zoid	zoids
zombie	zombies
zona	zonas
zonation	zonations
zone	zoned|zones|zoning
zoning	zonings
zonule	zonules
zoo	zoos
zoographer	zoographers
zookeeper	zookeepers
zoolite	zoolites
zoologist	zoologists
zoom	zooms|zooming|zoomed
zooming	zoomings
zoomorphism	zoomorphisms
zoophagan	zoophagans
zoophyte	zoophytes
zoopsychologist	zoopsychologists
zootechnician	zootechnicians
zootomist	zootomists
zootoxin	zootoxins
zwitterion	zwitterions
zygoneure	zygoneures
zygophyte	zygophytes
zygosphere	zygospheres
zygospore	zygospores
zygote	zygotes
zygotene	zygotenes
zygotomere	zygotomeres
zymad	zymads
zymase	zymases
zyme	zymes
zymin	zymins
zymogen	zymogens
zymologist	zymologists
zymometer	zymometers
zymosimeter	zymosimeters
zymurgy	zymurgies
