abort	abortane|aborten|abortar
abstrakt	abstrakta|abstraktet
adamseple	adamsepla|adamseplet
addisjon	addisjonar|addisjonen|addisjonane
adjektiv	adjektiva|adjektivet
administrasjon	administrasjonen|administrasjonar|administrasjonane
adressat	adressatar|adressaten|adressatane
adresse	adresser|adressa|adressene
advent	adventa|adventer|adventene
adventskalender	adventskalendrar|adventskalenderen|adventskalendrane
adverb	adverbet|adverba
advokat	advokaten|advokatane|advokatar
afrikansk	afrikanske
aggresjon	aggresjonar|aggresjonane|aggresjonen
agurk	agurken|agurkar|agurkane
akkord	akkorden|akkordar|akkordane
akrobat	akrobatar|akrobaten|akrobatane
akse	aksar|aksen|aksane
aksel	akslane|akselen|akslar
aksent	aksentar|aksentane|aksenten
aksjonær	aksjonærane|aksjonæren|aksjonærar
aktiv	aktivt|aktive
aktivitet	aktivitetane|aktivitetar|aktiviteten
aktuell	aktuelle|aktuelt
akupunktur	akupunkturen
alder	alderen|aldrar|aldrane
alfabet	alfabetet|alfabeta
alfabetisk	alfabetiske
alge	algen|algar|algane
alkohol	alkoholar|alkoholane|alkoholen
alkoholfri	alkoholfritt|alkoholfrie
alkoholmisbruk	alkoholmisbruket|alkoholmisbruken
allergi	allergiar|allergiane|allergien
allmenn	allment|allmenne
allé	alleane|alléen|allear|alléane|alléar|alleen
alter	altera|alteret
alternativ	alternativt|alternativet|alternative|alternativa
aluminium	aluminiumen|aluminiumet
ambassade	ambassadane|ambassadar|ambassaden
ambassadør	ambassadøren|ambassadørar|ambassadørane
ambulanse	ambulansen|ambulansane|ambulansar
analyse	analysar|analysane|analysen
anarki	anarkiet|anarkia
anbefaling	anbefalingane|anbefalinga|anbefalingar
and	endene|anda|ender
anekdote	anekdotane|anekdotar|anekdoten
anger	angeren
angre	angrar|angra|angrast|angrande
angrep	angrepa|angrepet
angripe	angripast|angripande|angreip|angrip
ankel	anklar|ankelen|anklane
anonym	anonymt|anonyme
anorakk	anorakken|anorakkar|anorakkane
ansikt	ansiktet|ansikta
ansvar	ansvaret|ansvara
antenne	antenner|antennene|antenna
apekatt	apekatten|apekattane|apekattar
apostel	apostlar|apostlane|apostelen
apparat	apparata|apparatet
appell	appellen|appellane|appellar
appelsin	appelsinen|appelsinar|appelsinane
appetitt	appetitten
aprikos	aprikosar|aprikosane|aprikosen
arabisk	arabisken|arabiske
arbeid	arbeidet|arbeida
argument	argumentet|argumenta
aristokrat	aristokraten|aristokratar|aristokratane
aritmetikk	aritmetikken
arkeolog	arkeologar|arkeologane|arkeologen
arkeologi	arkeologien
arkitekt	arkitekten|arkitektane|arkitektar
arkitektur	arkitekturar|arkitekturane|arkitekturen
arkiv	arkiva|arkivet
arm	armane|armt|armar|armen|arme
art	arta|artene|artane|arten|arter|artar
artikkel	artiklar|artikkelen|artiklane
arv	arven
arving	arvingen|arvingane|arvingar
asiat	asiatar|asiaten|asiatane
asiatisk	asiatiske
asjett	asjetten|asjettane|asjettar
ask	askane|asken|askar
assistent	assistentane|assistenten|assistentar
astma	astmaen
atom	atomet|atoma
atomvåpen	atomvåpenet|atomvåpena
attraksjon	attraksjonane|attraksjonen|attraksjonar
auke	aukar|aukast|aukane|auken|aukande|auka
auksjon	auksjonar|auksjonane|auksjonen
automat	automatar|automatane|automaten
automatisk	automatiske
autoritet	autoritetane|autoritetar|autoriteten
avdød	avdøde|avdødt
avertere	averter|averterte|averterande|averterast|averterer|avertert
avfall	avfallet
avgang	avgangar|avgangane|avgangen
avgrunn	avgrunnen|avgrunnar|avgrunnane
avhengig	avhengige
avis	avisa|aviser|avisene
avl	avlar|avlen|avlane
avslapping	avslappinga
avsnitt	avsnitta|avsnittet
avstand	avstandar|avstandane|avstanden
baby	babyane|babyen|babyar
bad	badet|bada
badebukse	badebuksene|badebuksa|badebukser
badekar	badekaret|badekara
bagasje	bagasjen
bajonett	bajonettar|bajonettane|bajonetten
bakeri	bakeriet|bakeria
bakgrunn	bakgrunnane|bakgrunnar|bakgrunnen
bakke	bakkar|bakkane|bakken
baksete	bakseta|baksetet
bakside	baksider|baksidene|baksida
bakterie	bakteriane|bakterien|bakteriar
balanse	balansar|balansen|balansane
balkong	balkongane|balkongar|balkongen
ball	ballar|ballen|ballet|balla|ballane
ballett	balletten|ballettane|ballettar
ballong	ballongar|ballongane|ballongen
banan	bananane|bananen|bananar
bandasje	bandasjane|bandasjen|bandasjar
bane	banane|baner|banene|banen|banar|bana
bank	bankar|bankane|banken
banke	bankar|bankane|banken
baptist	baptisten|baptistane|baptistar
bark	barkar|barken|barkane
barndom	barndomen|barndommen
barnebarn	barnebarnet|barnebarna|barneborna|barneborn
barnehage	barnehagane|barnehagar|barnehagen
barnevogn	barnevogner|barnevogna|barnevognene
baryton	barytonen|barytonar|barytonane
basar	basarane|basarar|basaren
batteri	batteriet|batteria
baug	baugar|baugen|baugane
be	bed|bedd|bedt|bedande|ber|bedi|beder|bad|bede
befolkning	befolkninga|befolkningane|befolkningar
behandling	behandlinga|behandlingar|behandlingane
behov	behovet|behova
behå	behåar|behåen|behåane
bein	beinet|beina
beite	beitet|beitast|beitar|beita|beitande
bekk	bekkar|bekkene|bekkane|bekker|bekken
belte	belta|beltet
bendelorm	bendelormar|bendelormen|bendelormane
benk	benkane|benkene|benker|benkar|benken
bensin	bensinen
bensinstasjon	bensinstasjonane|bensinstasjonar|bensinstasjonen
berømt	berømte
besetning	besetningane|besetningar|besetninga|besetningen
beskjed	beskjeda|beskjedane|beskjeden|beskjeder|beskjedene|beskjedar
beskjeden	beskjedne|beskjedent
bestefar	bestefaren|bestefedrane|bestefedrar
bestemor	bestemødrene|bestemødrer|bestemora
bestikk	bestikka|bestikket
bestilling	bestillingane|bestillinga|bestillingar
besøk	besøket|besøka
besøke	besøkte|besøker|besøkast|besøkande|besøk|besøkt
betaling	betalingar|betalinga|betalingane
betennelse	betennelsane|betennelsen|betennelsar
betong	betongen
bety	betyr|betydd|betydde
beundring	beundringa
bevisst	bevisste
bibel	bibelen|bibelar|bibelane
bibliotek	biblioteket|biblioteka
bibliotekar	bibliotekaren|bibliotekarar|bibliotekarane
bidrag	bidraga|bidraget
bikini	bikiniane|bikinien|bikiniar
bil	bilane|bilen|bilar
bilist	bilisten|bilistar|bilistane
billett	billetten|billettane|billettar
bind	bindet|binda
bindestrek	bindestreket|bindestrekar|bindestreken|bindestrekane|bindestreka
biologi	biologien
biologisk	biologiske
biskop	biskopar|biskopane|biskopen
bit	bitet|bitane|bitar|bita|biten
bite	biter|biti|beit|bit
bjørk	bjørkene|bjørker|bjørka
bjørn	bjørnane|bjørnar|bjørnen
blad	blada|bladet
blanding	blandingar|blandingane|blandinga
bleik	bleikaste|bleikare|bleikast|bleike|bleikt
blekksprut	blekksprutane|blekkspruten|blekksprutar
blind	blindt|blinde
blod	blodet
blodig	blodige
blodoverføring	blodoverføringa|blodoverføringar|blodoverføringane
blodtrykk	blodtrykket|blodtrykka
blokk	blokkar|blokkane|blokkene|blokka|blokken|blokker
blomsterbed	blomsterbedet|blomsterbeda
blomsterpotte	blomsterpottene|blomsterpotta|blomsterpotter
bluse	blusar|blusene|blusen|blusane|blusa|bluser
bly	blyet
blyant	blyanten|blyantar|blyantane
blå	blåaste|blåare|blått|blåast|blåe
blåbær	blåbæret|blåbæra
blære	blærene|blæra|blærer
boble	boblene|bobla|bobler
boikott	boikottar|boikotten|boikottane
bok	boka|bøkene|bøker
bokhandel	bokhandlar|bokhandlane|bokhandelen
bokhylle	bokhyller|bokhylla|bokhyllene
bokmål	bokmålet
boks	boksen|boksar|boksane
boksing	boksinga
bolle	bollen|bollane|bollar
bom	bommane|bommar|bommen
bombe	bombande|bomber|bombar|bomba|bombene|bombast
bombefly	bombeflyet|bombeflya
bomull	bomulla
bord	bordet|bordar|borda|borden|bordane
bordell	bordella|bordellane|bordellar|bordellet|bordellen
borg	borger|borga|borgene
botanikk	botanikken
brakk	brakt|brakke
brann	brannen|brannar|brannane
bratt	brattaste|brattare|brattast|bratte
braut	brautene|brauter|brauta
brems	bremsar|bremsane|bremsen
bremse	bremsa|bremser|bremsene
brennbar	brennbart|brennbare
brenne	brann|brennande|brennast|brunne|brenn
brennmanet	brennmaneter|brennmaneta|brennmanetene
brett	brettet|bretta
brev	brevet|breva
brille	brillene|briller|brilla
bringebær	bringebæra|bringebæret
brisling	brislingar|brislingen|brislingane
britisk	britiske
bronkitt	bronkittar|bronkittane|bronkitten
bru	bruene|bruer|brua
brud	brudene|bruda|bruder
brudekjole	brudekjolane|brudekjolar|brudekjolen
brudgom	brudgommar|brudgommane|brudgommen|brudgomen|brudgomar|brudgomane
brun	brunast|brunaste|brunare|brune|brunt
brur	brura|brurer|brurene
bryst	brystet|brysta
brystkreft	brystkreften
bryte	brote|braut|brytast|brytande|bryt
brøk	brøken|brøkar|brøkane
brøkdel	brøkdelen|brøkdelane|brøkdelar
budsjett	budsjettet|budsjetta
bukett	buketten|bukettane|bukettar
bukse	buksene|buksa|bukser
bukt	bukta|bukter|buktene
bulgar	bulgarar|bulgarane|bulgaren
bulgarsk	bulgarsken|bulgarske
bursdag	bursdagar|bursdagane|bursdagen
busk	busken|buskane|buskar
buss	bussar|bussane|bussen
butikk	butikkane|butikken|butikkar
butt	butte|buttast|buttare|buttaste
by	byen|byane|byar
bygd	bygda|bygdene|bygder
bygge	bygg|bygde|byggast|bygd|bygger|byggande
byråkrati	byråkratia|byråkratiet
båt	båtane|båtar|båten
bær	bæret|bæra
bølge	bølger|bølga|bølgene
bølgje	bølgjer|bølgjene|bølgja
børs	børsane|børsen|børsar
børste	børsten|børstar|børstane
bøtte	bøttene|bøtter|bøtta
campingvogn	campingvognene|campingvogner|campingvogna
celle	cella|cellene|celler
centimeter	centimetrane|centimeteren|centimeterane
clutch	clutchane|clutchar|clutchen
container	containerar|containerane|containeren
cupfinale	cupfinalane|cupfinalar|cupfinalen
dag	dagane|dagen|dagar
dagbok	dagboka|dagbøker|dagbøkene
dal	dalen|dalar|dalane
damp	dampane|dampen|dampar
dans	dansar|dansane|dansen
dansk	danske|dansken
danske	danskane|dansken|danskar
data	dataet|dataa
datamaskin	datamaskinen|datamaskiner|datamaskinane|datamaskinene|datamaskina|datamaskinar
dato	datoar|datoane|datoen
debatt	debatten|debattane|debattar
debut	debutane|debutar|debuten
definere	definer|definerer|definert|definerande|definerast|definerte
definisjon	definisjonen|definisjonar|definisjonane
dekk	dekket|dekka
dekke	dekte|dekt|dekkande|dekka|dekker|dekket|dekkast|dekk
del	delen|delane|delar
delegasjon	delegasjonane|delegasjonar|delegasjonen
delikatesse	delikatessa|delikatessene|delikatesser
delirium	deliria|deliriet
delta	deltaet|deltek|deltast|deltaa|deltatt|deltok|deltakande|deltar|delteke
demokrat	demokratane|demokraten|demokratar
demokrati	demokratia|demokratiet
demokratisk	demokratiske
desimal	desimalen|desimalar|desimalane
dessert	dessertane|desserten|dessertar
detalj	detaljen|detaljar|detaljane
detaljert	detaljerte
detaljist	detaljistar|detaljisten|detaljistane
detektiv	detektivane|detektiven|detektivar
diagnose	diagnosar|diagnosen|diagnosane
diakon	diakonane|diakonar|diakonen
dialekt	dialekten|dialekter|dialekta|dialektane|dialektar|dialektene
dialog	dialogen|dialogar|dialogane
diamant	diamantar|diamanten|diamantane
diameter	diametrar|diametrane|diameterane|diameteren|diameterar
diaré	diareane|diaréar|diarear|diaréane|diareen|diaréen
dikt	dikta|diktet
diktator	diktatoren|diktatorar|diktatorane
diktatur	diktaturet|diktatura
diplom	diploma|diplomet
diplomat	diplomatane|diplomatar|diplomaten
diplomati	diplomatia|diplomatiet
diplomatisk	diplomatiske
direktør	direktørar|direktørane|direktøren
dirigent	dirigentane|dirigentar|dirigenten
dis	disen
disig	disige
disk	disken|diskar|diskane
diskotek	diskoteka|diskoteket
diskusjon	diskusjonane|diskusjonen|diskusjonar
distrikt	distriktet|distrikta
divisjon	divisjonen|divisjonar|divisjonane
djevel	djevelen|djevlar|djevlane
dobbel	dobbelt|doble
dobbelt	dobbelte
dobbeltseng	dobbeltsenger|dobbeltsenga|dobbeltsengene
doktorgrad	doktorgradene|doktorgraden|doktorgrader|doktorgrada|doktorgradar|doktorgradane
dokument	dokumenta|dokumentet
dokumentmappe	dokumentmapper|dokumentmappene|dokumentmappa
dolk	dolken|dolkane|dolkar
domstol	domstolar|domstolane|domstolen
drabantby	drabantbyar|drabantbyane|drabantbyen
dramatisk	dramatiske
drap	drapet|drapa
drastisk	drastiske
dreiebenk	dreiebenkane|dreiebenkar|dreiebenker|dreiebenken|dreiebenkene
drepe	drap|drepande|drep|drepast
dress	dressen|dressane|dressar
drikk	drikkar|drikker|drikkane|drikkene|drikken
drivstoff	drivstoffa|drivstoffet
dronning	dronninga|dronningane|dronningar
drosje	drosjene|drosja|drosjer
drypp	dryppet|dryppa
duft	dufta|dufter|duftene
dverg	dvergen|dvergar|dvergane
dynamisk	dynamiske
dynamitt	dynamitten
død	dødt|dødast|døde|dødare|dødaste|døden
dødsstraff	dødsstraffene|dødsstraffer|dødsstraffa
døgn	døgna|døgnet
dør	dører|døra|dørene
dørmatte	dørmatter|dørmattene|dørmatta
dørslag	dørslaga|dørslaget
edderkopp	edderkoppen|edderkoppane|edderkoppar
eddik	eddikar|eddikane|eddiken
edel	edelt|edle|edlare|edlaste|edlast
edelstein	edelsteinen|edelsteinane|edelsteinar
effekt	effektar|effektane|effekten
egg	egget|egga
eggeplomme	eggeplommene|eggeplommer|eggeplomma
egyptisk	egyptiske
eid	eida|eiden|eidane|eidet|eidar
eigen	eige|eiga|eigne
eik	eika|eikene|eiker
ekko	ekkoa|ekkoet
ekkolodd	ekkoloddet|ekkolodda
ekorn	ekorna|ekornet
eksakt	eksakte
eksempel	eksempelet|eksempla
eksemplar	eksemplara|eksemplaret
eksemplarisk	eksemplariske
eksistens	eksistensane|eksistensar|eksistensen
eksistere	eksistert|eksisterer|eksister|eksisterte|eksisterast|eksisterande
eksos	eksosen
ekspedisjon	ekspedisjonen|ekspedisjonane|ekspedisjonar
eksperiment	eksperimenta|eksperimentet
eksplosjon	eksplosjonen|eksplosjonar|eksplosjonane
ekstrem	ekstreme|ekstremt
ekstremist	ekstremistane|ekstremistar|ekstremisten
ektemann	ektemannen|ektemennene|ektemenn
ektepar	ektepara|ekteparet
ekteskap	ekteskapa|ekteskapet
ekvator	ekvatorane|ekvatoren|ekvatorar
elastisk	elastiske
elefant	elefantar|elefantane|elefanten
elektrisitet	elektrisiteten
elektrisk	elektriske
elektromotor	elektromotorane|elektromotoren|elektromotorar
elektronikk	elektronikken
elektronisk	elektroniske
element	elementa|elementet
elementær	elementære|elementært
elg	elgane|elgar|elgen
elv	elvane|elver|elven|elvene|elvar|elva
emalje	emaljane|emaljen|emaljar
enda	endande|endast|endar
ende	endande|enden|endast|enda|endar|endane
endestasjon	endestasjonen|endestasjonar|endestasjonane
endre	endra|endrast|endrande|endrar
endring	endringar|endringa|endringane
energi	energien|energiane|energiar
engel	engelen|englar|englane
engelsk	engelske|engelskare|engelsken|engelskast|engelskaste
engelskmann	engelskmenn|engelskmennene|engelskmannen
enkel	enklaste|enklare|enkle|enklast|enkelt
enkelt	enkelte
enorm	enorme|enormt
entreprenør	entreprenøren|entreprenørane|entreprenørar
epidemi	epidemiane|epidemien|epidemiar
epilepsi	epilepsien
eple	epla|eplet
erfaren	erfare|erfarent|erfarne
erfaring	erfaringane|erfaringar|erfaringa
erklæring	erklæringane|erklæringar|erklæringa
erme	erma|ermet
erobre	erobrast|erobrande|erobra|erobrar
erstatning	erstatninga|erstatningane|erstatningar
esel	eselet|esla
eske	eska|esker|eskene
estetisk	estetiske
etablering	etableringa|etableringane|etableringar
etasje	etasjane|etasjen|etasjar
ete	etande|etast|åt|et
etikk	etikken
etnisk	etniske
ettermiddag	ettermiddagar|ettermiddagen|ettermiddagane
europeisk	europeiske
evangelium	evangelia|evangeliet
eventyr	eventyra|eventyret
evne	evna|evner|evnene
fabrikant	fabrikantar|fabrikanten|fabrikantane
fabrikk	fabrikkar|fabrikkane|fabrikken
faktor	faktorane|faktorar|faktoren
fall	fallet|falla
falle	falli|fallande|fell|fall|feller
fallskjerm	fallskjermar|fallskjermen|fallskjermane
falsk	falske|falskt
familie	familiar|familien|familiane
fanatisk	fanatiske
fantasi	fantasiar|fantasiane|fantasien
fantastisk	fantastiske
fare	farande|fer|fór|far|farast|faren|farar|farane
farge	fargen|fargar|fargene|farger|fargane|farga
farmasi	farmasien
farmasøyt	farmasøytane|farmasøyten|farmasøytar
fartsgrense	fartsgrenser|fartsgrensene|fartsgrensa
fartøy	fartøyet|fartøya
fascinere	fascinerer|fascinerte|fascinerande|fasciner|fascinerast|fascinert
fase	fasar|fasane|fasen
fast	faste
faste	faster|fasta|fastene
fastland	fastlanda|fastlandet
fattig	fattige|fattigaste|fattigare|fattigast
fattigdom	fattigdommen|fattigdomen
fe	feer|fea|feene
feiebrett	feiebretta|feiebrettet
feil	feila|feilen
feilaktig	feilaktige
feire	feirast|feirar|feira|feirande
felt	felta|feltet
fengsel	fengselet|fengsla
ferd	ferdene|ferder|ferda
ferdig	ferdige
ferje	ferjene|ferja|ferjer
fersk	ferskare|ferskast|ferske|ferskt|ferskaste
fest	festen|festar|festane
fetter	fetrar|fetteren|fetrane
fiasko	fiaskoen|fiaskoane|fiaskoar
fiende	fienden|fiendar|fiendane
fiken	fikenane|fikenen|fikenar
film	filmen|filmar|filmane
filmstjerne	filmstjerna|filmstjerner|filmstjernene
filologi	filologien
filosof	filosofane|filosofen|filosofar
filosofi	filosofiar|filosofien|filosofiane
fin	fine|finast|fint|finare|finaste
finale	finalen|finalane|finalar
finger	fingeren|fingrar|fingrane
fingeravtrykk	fingeravtrykket|fingeravtrykka
fingertupp	fingertuppar|fingertuppen|fingertuppane
finne	finnar|finnane|funne|finn|finnande|fann|finnast|finnen
fiolett	fiolette
fiolin	fiolinen|fiolinane|fiolinar
fisk	fiskar|fisken|fiskane
fiske	fisket
fiskebutikk	fiskebutikkane|fiskebutikken|fiskebutikkar
fiskebåt	fiskebåtane|fiskebåtar|fiskebåten
fjell	fjellet|fjella
fjellside	fjellsidene|fjellsider|fjellsida
fjerdedel	fjerdedelane|fjerdedelen|fjerdedelar
fjern	fjernaste|fjerne|fjernare|fjernast|fjernt
fjerne	fjernast|fjernande|fjerna|fjernar
fjernsyn	fjernsyna|fjernsynet
fjord	fjordar|fjordane|fjorden
flagg	flagga|flagget
flaske	flasker|flaskene|flaska
flaskehals	flaskehalsar|flaskehalsen|flaskehalsane
flass	flassa|flasset
flate	flatene|flata|flater
flaum	flaumen|flaumane|flaumar
flis	fliser|flisa|flisene
flokk	flokkar|flokkane|flokken
fluor	fluoren|fluoret
fly	flygast|floge|flygande|flyande|flyg|flyast|flydde|flya|flydd|flaug|flyr|flyet
flyge	flygast|floge|flyg|flygande|flaug
flykte	flyktande|flykta|flyktast|flyktar
flyktning	flyktningen|flyktningane|flyktningar
flyplass	flyplassen|flyplassar|flyplassane
flyselskap	flyselskapa|flyselskapet
flystripe	flystripene|flystriper|flystripa
flyvåpen	flyvåpena|flyvåpenet
flåte	flåtar|flåtane|flåten
fløy	fløyene|fløya|fløyer
fløyte	fløyta|fløyter|fløytene
fole	folane|folar|folen
folkemusikk	folkemusikken
forandring	forandringane|forandringa|forandringar
forbindelse	forbindelsar|forbindelsen|forbindelsane
forbløffe	forbløffa|forbløffar|forbløffast|forbløffande
fordel	fordelane|fordelen|fordelar
fordeling	fordelingane|fordelingar|fordelinga
forhandling	forhandlingar|forhandlingane|forhandlinga
forhold	forholda|forholdet
forhåpning	forhåpningane|forhåpningar|forhåpninga
forkaste	forkasta|forkastande|forkastast|forkastar
forklaring	forklaringane|forklaringar|forklaringa
forkorting	forkortingane|forkortingar|forkortinga
forlag	forlaga|forlaget
form	former|formene|forma
formel	formlane|formelen|formlar
formell	formelt|formelle
formue	formuane|formuen|formuar
forord	fororda|forordet
forsiktig	forsiktigast|forsiktige|forsiktigaste|forsiktigare
forskjellig	forskjellige
forslag	forslaga|forslaget
forstad	forstadene|forstaden|forstadane|forstadar|forstader
forsvar	forsvaret|forsvara
forsvare	forsvarar|forsvarast|forsvarande|forsvara
forsøk	forsøket|forsøka
fort	forte|fortast|fortare|forta|fortaste|fortet
fortau	fortauet|fortaua
fortid	fortida|fortidene|fortider
forum	foruma|forumet
forventning	forventninga|forventningane|forventningar
forvirra	forvirrande|forvirrast|forvirrar
forvirre	forvirrande|forvirrast|forvirra|forvirrar
forvirring	forvirringane|forvirringar|forvirringa
fosfor	fosforen|fosforet
foss	fossane|fossar|fossen
fot	føtene|foten|føter
fotball	fotballen|fotballane|fotballar
fotnote	fotnotane|fotnoten|fotnotar
foto	fotoa|fotoet
fotograf	fotografar|fotografen|fotografane
fotografi	fotografia|fotografien|fotografiet
frakt	frakta|fraktene|frakter
framgang	framgangen|framgangar|framgangane
framlegg	framlegga|framlegget
framtid	framtider|framtida|framtidene
fransk	franske|fransken
franskmann	franskmenn|franskmennene|franskmannen
frase	frasane|frasen|frasar
fred	freden
fredag	fredagen|fredagane|fredagar
fredstid	fredstida
frekvens	frekvensar|frekvensen|frekvensane
friksjon	friksjonen|friksjonar|friksjonane
frimerke	frimerket|frimerka
frisyre	frisyrane|frisyren|frisyrar
frosk	frosken|froskane|froskar
frost	frosten
frostvæske	frostvæsker|frostvæska|frostvæskene
frukt	frukta|frukter|fruktene
fruktbar	fruktbare|fruktbart
frykt	frykter|fryktene|frykta
frysepunkt	frysepunkta|frysepunktet
frø	frøet|frøa
fugl	fuglar|fuglen|fuglane
fugleperspektiv	fugleperspektivet
fullmåne	fullmånane|fullmånar|fullmånen
fullstendig	fullstendige
funksjon	funksjonen|funksjonar|funksjonane
furu	furuer|furuene|furua
fusjon	fusjonar|fusjonen|fusjonane
fylke	fylket|fylka
fyrstikk	fyrstikker|fyrstikka|fyrstikkene
fyrtårn	fyrtårnet|fyrtårna
fysikk	fysikken
fysisk	fysiske
få	færre|færrast|fått|fåande|fådd|fåast|får|fådde|færraste|fekk
fødselsdag	fødselsdagen|fødselsdagar|fødselsdagane
fødselsdato	fødselsdatoen|fødselsdatoar|fødselsdatoane
følelse	følelsane|følelsar|følelsen
følge	følgast|følg|følgd|følgande|følgde|følger
følgje	følg|følgjast|følgd|følgde|følgjer|følgjande
føre	førte|før|førast|førande|ført|fører
førstehjelp	førstehjelpa
gaffel	gaflar|gaflane|gaffelen
gaffeltruck	gaffeltruckane|gaffeltruckar|gaffeltrucken
galopp	galoppen|galoppar|galoppane
gammal	gamle|eldste|eldre|gammalt|eldst
garanti	garantiar|garantien|garantiane
garasje	garasjane|garasjar|garasjen
garderobe	garderoben|garderobar|garderobane
garderobeskap	garderobeskapa|garderobeskapet
gass	gassen|gassane|gassar
gasspedal	gasspedalane|gasspedalar|gasspedalen
gate	gater|gata|gatene
geit	geitene|geiter|geita
geitebukk	geitebukken|geitebukkane|geitebukkar
general	generalane|generalen|generalar
generasjon	generasjonen|generasjonar|generasjonane
geografi	geografien
geografisk	geografiske
gevær	geværa|geværet
gi	givast|givande|gav|gitt|gir
giftering	gifteringane|gifteringar|gifteringen
giftig	giftige
gigantisk	gigantiske
gips	gipsen
gir	giret|gira
girkasse	girkassar|girkassa|girkasser|girkassene|girkassane|girkassen
gissel	gislar|gisselen|gislane
gitar	gitarane|gitarar|gitaren
gitarist	gitaristen|gitaristane|gitaristar
gjeng	gjengane|gjengen|gjengar
gjenge	gjenget|gjenga
gjennomføre	gjennomførande|gjennomfør|gjennomførte|gjennomført|gjennomfører|gjennomførast
gjennomsnitt	gjennomsnittet|gjennomsnitta
gjensidig	gjensidige
gjenstand	gjenstandane|gjenstandar|gjenstanden
gjerde	gjerdet|gjerda
gjerning	gjerningane|gjerningar|gjerninga
gjerningsmann	gjerningsmenn|gjerningsmennene|gjerningsmannen
gjest	gjestene|gjester|gjestane|gjestar|gjesten
gjestfri	gjestfritt|gjestfrie
gjær	gjæren
glidelås	glidelåsa|glidelåsar|glidelåset|glidelåsen|glidelåsane
globus	globusar|globusane|globusen
god	best|godt|gode|betre|beste
gods	godsa|godset
grammatikk	grammatikken|grammatikkar|grammatikkane
granitt	granittar|granitten|granittane
grave	gravande|grev|gravast|grav|grov
gravemaskin	gravemaskina|gravemaskiner|gravemaskinen|gravemaskinene|gravemaskinar|gravemaskinane
gravid	gravide
graviditet	graviditetane|graviditeten|graviditetar
grei	greiast|greiaste|greiare|greie|greitt
greie	greier|greia|greiene
grense	grenser|grensa|grensene
gresk	greske|gresken
gris	griser|grisene|grisane|grisen|grisar
grossist	grossistar|grossistane|grossisten
grov	grovaste|grovare|grove|grovt|grovast
grunn	grunnen|grunnane|grunnar|grunt|grunne
grunnflate	grunnflata|grunnflater|grunnflatene
grunnlag	grunnlaga|grunnlaget
grunnmur	grunnmuren|grunnmurar|grunnmurane
grunnskole	grunnskolane|grunnskolen|grunnskolar
gruppe	grupper|gruppa|gruppene
grus	gruset|grusen
gruve	gruver|gruva|gruvene
grå	grått|gråast|gråare|gråe|gråaste
grådig	grådigare|grådige|grådigaste|grådigast
gråt	gråten
gråte	gret|gråtande|græt|gråt|gråtast
gudinne	gudinnene|gudinna|gudinner
gul	gulaste|gulare|gulast|gule|gult
gull	gullet
gullfisk	gullfisken|gullfiskar|gullfiskane
gulrot	gulrotene|gulroter|gulrota
gummi	gummiane|gummiar|gummien
gummistøvel	gummistøvlar|gummistøvlane|gummistøvelen
gyldig	gyldige
gyllen	gylne|gyllent|gylle
gyngehest	gyngehestar|gyngehestane|gyngehesten
gyngestol	gyngestolar|gyngestolane|gyngestolen
gå	gådd|går|gådde|gåande|gåast
gås	gjæsene|gjæser|gåsa
ha	hatt|hadde|havast|havande|har
hage	hagane|hagen|hagar
hagl	haglet|hagla
hagle	haglene|hagler|hagla
haglgevær	haglgeværa|haglgeværet
hai	haiane|haiar|haien
hake	haka|haken|hakane|hakar|hakene|haker
hakekors	hakekorsa|hakekorset
hale	halar|halen|halane
hals	halsen|halsar|halsane
halv	halve|halvt
halvdel	halvdelar|halvdelane|halvdelen
halvtime	halvtimen|halvtimar|halvtimane
halvår	halvåret|halvåra
halvøy	halvøyane|halvøyer|halvøya|halvøyene|halvøyar
hamn	hamnene|hamner|hamna
hand	hender|handa|hendene
handel	handlane|handlar|handelen
handelsflåte	handelsflåten|handelsflåtane|handelsflåtar
handelsskip	handelsskipet|handelsskipa
handveske	handvesker|handveska|handveskene
hane	hanane|hanen|hanar
hank	hankar|hankane|hanken|hanka|hankene|hanker
hankjønn	hankjønna|hankjønnet
hanske	hanskar|hanskane|hansken
hard	hardaste|harde|hardast|hardare|hardt
hardfør	hardføre|hardført
hat	hatet
hatt	hattar|hattane|hatten
haug	haugen|haugane|haugar
hauk	haukane|hauken|haukar
haust	haustane|haustar|hausten
hav	havet|havsens|hava
have	hatt|hadde|hav|havast|havande|har
heil	heilaste|heilare|heile|heilt|heilast
heimebrent	heimebrenten
hekk	hekkar|hekkane|hekken
heks	hekser|heksa|heksene
hektar	hektaret|hektara
heldig	heldige
helg	helgane|helga|helgar|helger|helgene
helgen	helgenar|helgenane|helgenen
helikopter	helikoptera|helikopteret
helle	heller|hella|hellene
helse	helsa
helt	heltar|helten|heltane
hengelås	hengelåsane|hengelåset|hengelåsen|hengelåsar|hengelåsa
hengsel	hengselet|hengsla
her	herane|heren|herar
hest	hestar|hesten|hestane
hestekraft	hestekrafta|hestekraftene|hestekrafter
hestesko	hesteskoa|hesteskorne|hesteskor|hesteskoen
hete	heta|heten|hetar
hette	hetter|hetta|hettene
hevde	hevdande|hevda|hevdar|hevdast
hevelse	hevelsar|hevelsane|hevelsen
himmel	himmelar|himmelen|himmelane
historie	historia|historier|historiene
historisk	historiske
hjelm	hjelmen|hjelmane|hjelmar
hjelp	hjelpa
hjelpe	hjelpande|hjelpt|hjelpast|hjelpte|hjelper|hjelp
hjelpemiddel	hjelpemidla|hjelpemiddelet
hjerne	hjernen|hjernar|hjernane
hjort	hjortar|hjorten|hjortane
hjul	hjula|hjulet
hjørne	hjørnet|hjørna
hofte	hofter|hoftene|hofta
homoseksualitet	homoseksualiteten
honning	honningen
hopp	hoppa|hoppet
hoppe	hoppa|hopper|hoppene
horisont	horisontar|horisonten|horisontane
hormon	hormonet|hormona
horn	horna|hornet
hotell	hotellet|hotella
humor	humoren
humoristisk	humoristiske
hund	hunden|hundane|hundar
hundeliv	hundelivet
hus	huset|husa
husdyr	husdyret|husdyra
hustru	hustruer|hustrua|hustruene
hydrogen	hydrogenet
hygiene	hygienen
hygienisk	hygieniske
hylle	hyllene|hylla|hyller
hysterisk	hysteriske
hytte	hyttene|hytter|hytta
håp	håpet|håpa
håpe	håpa|håpar|håpast|håpande
håpefull	håpefullt|håpefulle
hår	håra|håret
hårbørste	hårbørstar|hårbørsten|hårbørstane
hæl	hælen|hælar|hælane
hær	hæren|hærar|hærane
hærverk	hærverket|hærverka
høg	høgre|høgt|høge|høgst|høgste
høgskole	høgskolane|høgskolen|høgskolar
høne	høna|høns|høner|hønene
høns	hønsa
høre	hørde|hørast|hørande|hørt|hører|hør
høyre	høyrande|høyrde|høyrt|høyr|høyrast|høyrer
ideell	ideelt|ideelle
identisk	identiske
identitet	identitetane|identiteten|identitetar
ideologi	ideologien|ideologiar|ideologiane
idrett	idrettar|idretten|idrettane
idé	idéane|idear|idéar|idéen|ideen|ideane
illustrasjon	illustrasjonane|illustrasjonen|illustrasjonar
imponere	imponerande|imponert|imponer|imponerte|imponerer|imponerast
importør	importøren|importørar|importørane
improvisasjon	improvisasjonar|improvisasjonen|improvisasjonane
indeks	indeksar|indeksane|indeksen
indisk	indiske
individ	individa|individet
indonesisk	indonesisken|indonesiske
industri	industrien|industriane|industriar
industriell	industrielt|industrielle
infeksjon	infeksjonen|infeksjonane|infeksjonar
inflasjon	inflasjonen|inflasjonar|inflasjonane
influensa	influensaen|influensaer|influensaene
informasjon	informasjonane|informasjonar|informasjonen
ingeniør	ingeniørar|ingeniøren|ingeniørane
initiativ	initiativa|initiativet
innføring	innføringane|innføringar|innføringa
inngang	inngangar|inngangen|inngangane
innkjøp	innkjøpa|innkjøpet
innsjø	innsjøane|innsjøar|innsjøen
inntekt	inntekta|inntektene|inntekter
inntektsskatt	inntektsskattane|inntektsskattar|inntektsskatten
inntrykk	inntrykket|inntrykka
insekt	insekta|insektet
inspirasjon	inspirasjonar|inspirasjonen|inspirasjonane
instrument	instrumentet|instrumenta
interiør	interiøret|interiøra
interjeksjon	interjeksjonar|interjeksjonen|interjeksjonane
intern	interne|internt
internasjonal	internasjonale|internasjonalt
internatskole	internatskolen|internatskolar|internatskolane
intervju	intervjua|intervjuet
intim	intimt|intime
invasjon	invasjonar|invasjonen|invasjonane
investering	investeringar|investeringa|investeringane
invitere	invitert|inviterast|inviter|inviterande|inviterte|inviterer
ironi	ironiane|ironien|ironiar
ironisk	ironiske
irsk	irske|irsken
is	isane|isen|isar
isbjørn	isbjørnane|isbjørnar|isbjørnen
isbre	isbreane|isbrear|isbreen
isfjell	isfjellet|isfjella
iskald	iskalde|iskaldt
iskrem	iskremar|iskremen|iskremane
islandsk	islandske|islandsken
islending	islendingen|islendingar|islendingane
isolasjon	isolasjonen
istid	istidene|istida|istider
italiensk	italiensken|italienske
jakke	jakkene|jakker|jakka
jakt	jaktene|jakter|jakta
japansk	japanske|japansken
jazz	jazzen
jekk	jekken|jekkane|jekkar
jente	jenta|jentene|jenter
jernbane	jernbanen|jernbanar|jernbanene|jernbaner|jernbanane|jernbana
jernbanestasjon	jernbanestasjonen|jernbanestasjonane|jernbanestasjonar
jobb	jobbane|jobben|jobbar
jomfru	jomfruer|jomfruene|jomfrua
jord	jorda
jordbruk	jordbruka|jordbruket
jordbær	jordbæret|jordbæra
jordmor	jordmødrene|jordmora|jordmødrer
jordskjelv	jordskjelven|jordskjelvane|jordskjelvar|jordskjelva|jordskjelvet
jordskred	jordskreda|jordskredet
jordsmonn	jordsmonnet|jordsmonna
journalist	journalistar|journalistane|journalisten
juletre	juletret|juletra
jungel	jungelar|jungelen|jungelane
juridisk	juridiske
juvel	juvelar|juvelen|juvelane
jødedom	jødedommen|jødedomen
jødisk	jødiske
kabel	kablar|kabelen|kablane
kabinett	kabinetta|kabinettet
kafé	kafeane|kafeen|kafear|kaféen|kaféane|kaféar
kai	kaiane|kaien|kaiar|kaier|kaia|kaiene
kake	kaker|kakene|kaka
kaktus	kaktusar|kaktusen|kaktusane
kald	kaldare|kaldt|kalde|kaldaste|kaldast
kalender	kalenderen|kalendrane|kalendrar
kalk	kalken|kalkar|kalkane
kalkstein	kalksteinen|kalksteinane|kalksteinar
kalkulator	kalkulatorane|kalkulatorar|kalkulatoren
kalkun	kalkunar|kalkunen|kalkunane
kalv	kalven|kalvar|kalvane
kalvekjøtt	kalvekjøttet
kam	kammar|kammane|kammen
kamel	kamelar|kamelane|kamelen
kamera	kameraa|kameraet
kamp	kampar|kampen|kampane
kampanje	kampanjane|kampanjen|kampanjar
kamuflasje	kamuflasjen|kamuflasjane|kamuflasjar
kanal	kanalar|kanalen|kanalane
kanel	kanelen
kanin	kaninane|kaninen|kaninar
kano	kanoen|kanoane|kanoar
kanon	kanonar|kanonen|kanonane
kaos	kaoset
kaotisk	kaotiske
kapasitet	kapasitetane|kapasiteten|kapasitetar
kapitalisme	kapitalismen
kapitalist	kapitalistar|kapitalisten|kapitalistane
kapittel	kapitla|kapittelet
kapsel	kapslane|kapselen|kapslar
kaptein	kapteinen|kapteinar|kapteinane
karakter	karakteren|karakterane|karakterar
karriere	karrieren|karrierar|karrierane
kart	karten|kartane|karta|kartet|kartar
kasserolle	kasserollane|kasserollen|kasserollar
kassett	kassettar|kassetten|kassettane
kast	kastet|kasta
kaste	kastande|kastane|kasten|kastast|kasta|kastar
katalog	katalogar|katalogane|katalogen
katastrofal	katastrofalt|katastrofale
katastrofe	katastrofar|katastrofen|katastrofane
kategori	kategoriar|kategorien|kategoriane
kateter	katetera|kateteret
katolikk	katolikkane|katolikken|katolikkar
katolisisme	katolisismen
katolsk	katolske
katt	katten|kattane|kattar
kattunge	kattungen|kattungane|kattungar
keramikk	keramikken
kikkert	kikkertane|kikkertar|kikkerten
kilometer	kilometerane|kilometeren|kilometrane
kinesisk	kinesiske|kinesisken
kinn	kinna|kinnet
kino	kinoane|kinoar|kinoen
kiosk	kioskane|kiosken|kioskar
kiropraktor	kiropraktorane|kiropraktoren|kiropraktorar
kirsebær	kirsebæra|kirsebæret
kirurg	kirurgen|kirurgar|kirurgane
kirurgi	kirurgien
kirurgisk	kirurgiske
kjede	kjeder|kjeda|kjedene
kjeks	kjeksen|kjeksa
kjemi	kjemien
kjemisk	kjemiske
kjempe	kjempa|kjempene|kjemper
kjendis	kjendisane|kjendisar|kjendisen
kjenne	kjennande|kjenn|kjenner|kjent|kjennast|kjende
kjennskap	kjennskapane|kjennskapen|kjennskapar
kjent	kjente
kjerne	kjernen|kjernar|kjernane
kjernefamilie	kjernefamilien|kjernefamiliane|kjernefamiliar
kjernefysikk	kjernefysikken
kjeve	kjevar|kjevane|kjeven
kjevle	kjevlar|kjevlande|kjevlast|kjevlet|kjevla
kjole	kjolen|kjolane|kjolar
kjæledyr	kjæledyra|kjæledyret
kjær	kjæraste|kjært|kjærast|kjærare|kjære
kjøkken	kjøkkena|kjøkkenet
kjøkkenbenk	kjøkkenbenkane|kjøkkenbenkene|kjøkkenbenkar|kjøkkenbenker|kjøkkenbenken
kjøleskap	kjøleskapa|kjøleskapet
kjølig	kjøligaste|kjøligare|kjøligast|kjølige
kjønn	kjønnet|kjønna
kjøp	kjøpa|kjøpet
kjøpe	kjøpande|kjøper|kjøpt|kjøpte|kjøp|kjøpast
kjøpesenter	kjøpesentera|kjøpesenteret
kjøpmann	kjøpmenn|kjøpmennene|kjøpmannen
kjøtt	kjøttet
kjøttdeig	kjøttdeigen|kjøttdeigane|kjøttdeigar
klasse	klassa|klassane|klassene|klasser|klassar|klassen
klasserom	klasseromma|klasserommet
klassisk	klassiske
klegg	kleggar|kleggene|kleggane|klegger|kleggen
klesbørste	klesbørsten|klesbørstane|klesbørstar
klesplagg	klesplagget|klesplagga
klesskap	klesskapet|klesskapa
klima	klimaet|klimaa
klimatisk	klimatiske
klinikk	klinikkar|klinikkane|klinikken
klippe	klipper|klippa|klippene
klo	kloa|klørne|klør
klokke	klokka|klokker|klokkene
kloster	klosteret|klostera
klovn	klovnen|klovnane|klovnar
klubb	klubben|klubbar|klubbane
klump	klumpen|klumpane|klumpar
klut	klutane|klutar|kluten
knapp	knappar|knappen|knappane
kne	kneet|knea
kniv	knivar|kniven|knivane
knute	knuten|knutar|knutane
knyttneve	knyttnevane|knyttnevar|knyttneven
koffert	koffertane|koffertar|kofferten
kokebok	kokebøker|kokebøkene|kokeboka
kokepunkt	kokepunkta|kokepunktet
kokk	kokkane|kokkar|kokken
kokke	kokker|kokkene|kokka
kol	kolet
kolera	koleraen
kollega	kollegaar|kollegaene|kollegaen|kollegaer|kollegaane
kollektiv	kollektive|kollektivet|kollektivt|kollektiva
kollisjon	kollisjonar|kollisjonen|kollisjonane
kolon	kolona|kolonet
koloni	koloniar|kolonien|koloniane
kolonne	kolonnen|kolonnane|kolonnar
kombinasjon	kombinasjonar|kombinasjonen|kombinasjonane
komedie	komediane|komediar|komedien
komfyr	komfyren|komfyrane|komfyrar
komisk	komiske
komité	komiteen|komitéen|komiteane|komitéane|komitéar|komitear
komma	kommaet|kommaa|kom|kommande|kjem|komme|kommast
komme	kommande|kom|kommast|kjem
kommentar	kommentaren|kommentarane|kommentarar
kommersiell	kommersielle|kommersielt
kommune	kommunane|kommunar|kommunen
kommunikasjon	kommunikasjonen|kommunikasjonar|kommunikasjonane
kommunist	kommunisten|kommunistar|kommunistane
komparativ	komparativen|komparative|komparativar|komparativane|komparativt
kompetanse	kompetansen|kompetansar|kompetansane
kompleks	komplekset|kompleksa|komplekse|komplekst
komponist	komponistane|komponisten|komponistar
konditor	konditorar|konditorane|konditoren
kone	kona|konene|koner
konferanse	konferansane|konferansar|konferansen
konflikt	konflikten|konfliktar|konfliktane
kongerike	kongeriket|kongerika
kongle	konglene|kongler|konglar|kongla|konglen|konglane
konklusjon	konklusjonar|konklusjonane|konklusjonen
konkurranse	konkurransar|konkurransen|konkurransane
konkurrent	konkurrenten|konkurrentar|konkurrentane
konkurrere	konkurrerast|konkurrerande|konkurrert|konkurrerer|konkurrer|konkurrerte
konsentrasjon	konsentrasjonar|konsentrasjonen|konsentrasjonane
konsentrere	konsentrerast|konsentrer|konsentrert|konsentrerte|konsentrerande|konsentrerer
konsert	konsertane|konsertar|konserten
konsonant	konsonanten|konsonantane|konsonantar
konsulent	konsulentar|konsulentane|konsulenten
konsum	konsumet
kontakt	kontakten|kontaktane|kontaktar
kontaktlinse	kontaktlinser|kontaktlinsene|kontaktlinsa
kontinent	kontinentet|kontinenta
kontor	kontoret|kontora
kontrakt	kontraktar|kontrakten|kontraktane
kontroll	kontrollen|kontrollar|kontrollane
konvolutt	konvolutten|konvoluttane|konvoluttar
kopp	koppar|koppen|koppane
kor	kora|koret
korallrev	korallrevet|korallreva
kork	korkar|korkane|korken
korn	korna|kornet
korrekt	korrekte
korridor	korridoren|korridorane|korridorar
korsett	korsetta|korsettet
kort	kortaste|korta|kortet|kortast|kortare|korte
kose	kosast|kosar|kosande|kosa
kost	kosten|kostane|kostar
kostbar	kostbare|kostbart
krabbe	krabbane|krabba|krabbene|krabbar|krabber|krabben
kraft	krafter|krefter|kreftene|krafta|kraftene
kraftig	kraftige|kraftigare|kraftigast|kraftigaste
kraftverk	kraftverket|kraftverka
krakk	krakkar|krakkane|krakken
krampe	krampar|krampane|krampen
kran	kranene|kraner|krana
krangel	kranglane|krangla|krangelet|krangelen|kranglar
krav	kravet|krava
kreditor	kreditorar|kreditorane|kreditoren
kredittkort	kredittkortet|kredittkorta
kreft	kreften
krem	kremen|kremar|kremane
kremasjon	kremasjonar|kremasjonen|kremasjonane
kresen	kresent|kresne|krese
krets	kretsar|kretsen|kretsane
krigføring	krigføringar|krigføringane|krigføringa
kristendom	kristendomen|kristendommen
kritikk	kritikken|kritikkar|kritikkane
kritisk	kritiske
krokodille	krokodillar|krokodillen|krokodilla|krokodillane|krokodillene|krokodiller
krone	kronar|kronande|kroner|kronast|kronene|krona
kronhjort	kronhjortar|kronhjorten|kronhjortane
kronisk	kroniske
kropp	kroppar|kroppane|kroppen
krydder	krydderet|kryddera
krypdyr	krypdyret|krypdyra
kryss	krysset|kryssa
krystall	krystallane|krystallen|krystalla|krystallar|krystallet
kråke	kråkene|kråka|kråker
krøll	krøllar|krøllane|krøllen
kulde	kulda|kulden
kule	kula|kulene|kuler
kuleramme	kulerammer|kulerammene|kuleramma
kull	kulla|kullet
kultur	kulturar|kulturane|kulturen
kulturell	kulturelle|kulturelt
kunde	kundar|kundane|kunden
kunnskap	kunnskapen|kunnskapane|kunnskapar
kunst	kunstene|kunstar|kunstane|kunsten|kunster|kunsta
kunstgalleri	kunstgalleriet|kunstgalleria
kunstig	kunstige
kunstverk	kunstverket|kunstverka
kupong	kupongar|kupongane|kupongen
kupp	kuppet|kuppa
kurs	kurset|kursen|kursa|kursane|kursar
kusine	kusina|kusinene|kusiner
kvadrat	kvadratet|kvadrata
kvadratmeter	kvadratmeteren|kvadratmetrane|kvadratmeterane
kvadratrot	kvadratrøter|kvadratrota|kvadratrøtene
kval	kvalane|kvalar|kvalen
kvalitet	kvaliteten|kvalitetar|kvalitetane
kvartal	kvartalet|kvartala
kvartett	kvartettane|kvartetten|kvartettar
kveite	kveita|kveiten|kveitene|kveiter
kvikksølv	kvikksølvet
kvile	kvil|kvilt|kvilte|kvilande|kviler|kvilast
kvinne	kvinner|kvinna|kvinnene
kvinnfolk	kvinnfolka|kvinnfolket
kvit	kvite|kvitaste|kvitast|kvitt|kvitare
kvitløk	kvitløken|kvitløkar|kvitløkane
kylling	kyllingane|kyllingar|kyllingen
kynisk	kyniske
kyss	kyssa|kyssen|kyssane|kyssar|kysset
kø	køar|køane|køen
la	late|let|latt|lét|lar|lèt
laboratorium	laboratoria|laboratoriet
lag	laga|laget
lager	lagera|lageret
lagring	lagringa|lagringar|lagringane
lam	lamma|lamt|lammet|lamme
lampe	lampen|lamper|lampar|lampa|lampane|lampene
lampeskjerm	lampeskjermen|lampeskjermar|lampeskjermane
land	landet|landa
landing	landingar|landinga|landingane
landkrabbe	landkrabber|landkrabbane|landkrabbene|landkrabben|landkrabba|landkrabbar
landsby	landsbyar|landsbyen|landsbyane
landsbygd	landsbygda|landsbygdene|landsbygder
landskap	landskapa|landskapet
landssvik	landssviket|landssvika
lang	lange|lengste|lengre|lengst|langt
langfinger	langfingrar|langfingrane|langfingeren
langfredag	langfredagen|langfredagar|langfredagane
langrenn	langrennet|langrenna
langtidsvarsel	langtidsvarselet|langtidsvarsla
larve	larvane|larva|larven|larver|larvene|larvar
last	lastar|lastane|laster|lastene|lasten|lasta
lastebil	lastebilen|lastebilar|lastebilane
lauk	laukane|laukar|lauken
ledd	ledda|leddet
lege	legen|legar|legane
legemiddel	legemidla|legemiddelet
legg	leggane|leggene|leggen|leggar|legger
legitim	legitime|legitimt
leikeplass	leikeplassen|leikeplassar|leikeplassane
leiketøy	leiketøyet|leiketøya
leire	leira
lekse	lekser|leksene|leksa
lenestol	lenestolen|lenestolane|lenestolar
lengd	lengdene|lengder|lengda
lengde	lengdene|lengder|lengda
lengdegrad	lengdegradane|lengdegraden|lengdegradar|lengdegrader|lengdegradene|lengdegrada
lengsel	lengselen|lengslane|lengslar
leppe	lepper|leppene|leppa
leppestift	leppestiftar|leppestiftane|leppestiften
lesbisk	lesbiske
lese	les|lesast|las|lesande
lett	lettare|lettaste|lettast|lette
levemann	levemannen|levemennene|levemenn
lever	levrene|levrar|levra|levrer|levrane
leverandør	leverandørane|leverandørar|leverandøren
levering	leveringane|leveringar|leveringa
ligge	ligg|liggast|lege|låg|liggande
lilje	liljer|liljene|lilja
lim	lima|limet
linse	linsa|linsene|linser
lisens	lisensane|lisensar|lisensen
liste	lister|lista|listene
lite	litast|lit|leit|litande
liten	lita|små|litle|mindre|lite|minste|minst
litteratur	litteraturane|litteraturar|litteraturen
litterær	litterære|litterært
liv	livsens|livet|liva
livbåt	livbåtane|livbåtar|livbåten
livmor	livmorene|livmorer|livmora
ljuge	ljug|loge|lyg|ljugande|laug|ljugast
lokomotiv	lokomotivet|lokomotiva
lomme	lomma|lommene|lommer
lommebok	lommebøkene|lommeboka|lommebøker
lov	lover|lovene|lova|lovar|lovane|loven
luft	lufta
luftforsvar	luftforsvaret|luftforsvara
lugar	lugarane|lugaren|lugarar
luksus	luksusen
lukt	luktene|lukta|lukter
luktesans	luktesansen
luktfri	luktfrie|luktfritt
lunge	lungene|lunga|lunger
lunken	lunke|lunkent|lunkne
lunsj	lunsjar|lunsjen|lunsjane
lydpotte	lydpotta|lydpottene|lydpotter
lyge	lygande|loge|lyg|laug|lygast
lyn	lyna|lynet
lys	lyset|lysa
lyspære	lyspæra|lyspærer|lyspærene
lysår	lysåra|lysåret
lån	låna|lånet
lånord	lånordet|lånorda
lår	låret|låra
lås	låsa|låsar|låsen|låsane|låset
lærebok	læreboka|lærebøker|lærebøkene
lærepenge	lærepengane|lærepengar|lærepengen
lærling	lærlingar|lærlingane|lærlingen
løfte	løftet|løfta
løgn	løgnene|løgner|løgna
løk	løkane|løkar|løken
lønn	lønnen|lønnene|lønnar|lønnane|lønna|lønner
løp	løpet|løpa
løvetann	løvetannene|løvetanner|løvetanna
løyse	løysande|løysast|løyser|løyste|løyst|løys
løytnant	løytnantane|løytnantar|løytnanten
madrass	madrassane|madrassar|madrassen
mage	magane|magar|magen
magedans	magedansen|magedansane|magedansar
mager	magre|magert
magnet	magnetar|magnetane|magneten
magnetisk	magnetiske
majestetisk	majestetiske
majones	majonesen|majonesar|majonesane
majoritet	majoriteten|majoritetane|majoritetar
makrell	makrellar|makrellen|makrellane
maksimal	maksimale|maksimalt
maksimum	maksimumet|maksimuma
makt	maktene|makta|makter
malm	malmane|malmen|malmar
mamma	mammaer|mammaa|mammaene
man	manene|mana|maner
mandel	mandlar|mandelen|mandlane
manet	maneter|maneta|manetene
mange	flest|fleire
mangel	mangelen|manglane|manglar
mangelfull	mangelfullt|mangelfulle
mangemillionær	mangemillionæren|mangemillionærar|mangemillionærane
mann	mannen|mennene|menn
mannfolk	mannfolket|mannfolka
mannskap	mannskapa|mannskapet
manuell	manuelt|manuelle
manuskript	manuskripta|manuskriptet
manøver	manøveren|manøverar|manøverane
mareritt	mareritta|marerittet
marg	margen|margar|margane
marine	marinar|marinane|marinen
mark	markar|marka|markane|marken|marker|markene
marknad	marknadene|marknader|marknadar|marknaden|marknadane
marmor	marmoret|marmoren
martyr	martyren|martyrar|martyrane
maske	masker|maskene|maska
maskin	maskinen|maskinene|maskinar|maskina|maskinane|maskiner
maskingevær	maskingeværet|maskingeværa
massakre	massakrar|massakrane|massakren
massasje	massasjane|massasjar|massasjen
masse	massar|massane|massen
massiv	massive|massivt
mat	maten
matematikk	matematikken
matematisk	matematiske
materiale	materialet|materiala
matte	mattene|matta|matter|matten
maur	maurar|maurane|mauren
medikament	medikamenta|medikamentet
medisin	medisinane|medisinar|medisinen
medisinsk	medisinske
medlem	medlemmar|medlemen|medlemene|medlemmer|medlemmen|medlemane|medlemmene|medlemmane|medlemer|medlemar
medlemskap	medlemskapar|medlemskapen|medlemskapane|medlemskapet|medlemskapa
medlemskort	medlemskorta|medlemskortet
meine	mein|meinte|meinast|meiner|meinande|meint
meining	meininga|meiningane|meiningar
mekanikk	mekanikken
mekanisk	mekaniske
mellomrom	mellomrommet|mellomromma
melodi	melodien|melodiane|melodiar
melon	melonane|melonar|melonen
men	menet
menneske	mennesket|menneska
menstruasjon	menstruasjonar|menstruasjonen|menstruasjonane
meny	menyar|menyen|menyane
merke	merka|merket
messing	messingen
metall	metallet|metalla
meteor	meteoren|meteorar|meteorane
meteorolog	meteorologar|meteorologane|meteorologen
meteorologi	meteorologien
meteorologisk	meteorologiske
meter	meteren|metrane|meterane
metode	metodar|metodane|metoden
middag	middagar|middagen|middagane
middel	midla|middelet
midje	midjene|midjer|midja
midnattssol	midnattssola
midt	midten
migrene	migrenen
mikrofon	mikrofonen|mikrofonar|mikrofonane
mikroorganisme	mikroorganismen|mikroorganismar|mikroorganismane
mikrosekund	mikrosekundet|mikrosekunda
mikroskop	mikroskopa|mikroskopet
militær	militære|militært
militærkupp	militærkuppa|militærkuppet
miljø	miljøet|miljøa
millimeter	millimetrane|millimeterane|millimeteren
million	millionen|millionar|millionane
millionær	millionærane|millionæren|millionærar
mindretal	mindretala|mindretalet
mine	minen|minane|minar
mineral	minerala|mineralet
minimal	minimale|minimalt
minimum	minimumet|minimuma
miniskjørt	miniskjørta|miniskjørtet
minister	ministeren|ministrar|ministrane
minne	minna|minnet
minoritet	minoriteten|minoritetar|minoritetane
minusgrad	minusgrada|minusgradene|minusgradane|minusgraden|minusgradar|minusgrader
minutt	minuttane|minuttar|minutten|minutta|minuttet
mirakel	mirakla|mirakelet
misbruk	misbruket|misbruken
misjon	misjonane|misjonen|misjonar
misjonær	misjonæren|misjonærar|misjonærane
mistanke	mistankane|mistanken|mistankar
mjølk	mjølka
modell	modellar|modellane|modellen
modellfly	modellflyet|modellflya
moden	modent|mode|modne
molekyl	molekyla|molekylet
monarki	monarkia|monarkiet
monolog	monologar|monologen|monologane
moped	mopedar|mopeden|mopedane
moralsk	moralske
mord	morda|mordet
mordvåpen	mordvåpena|mordvåpenet
morsmjølk	morsmjølka
morsmål	morsmåla|morsmålet
morter	morteren|morterar|morterane
moské	moskeen|moskéane|moskeane|moskéen|moskear|moskéar
mot	motet
mote	motane|motar|moten
motiv	motiva|motivet
motor	motoren|motorane|motorar
motorsykkel	motorsyklar|motorsyklane|motorsykkelen
motsetning	motsetningane|motsetninga|motsetningar
motstand	motstandar|motstandane|motstanden
multiplikasjon	multiplikasjonane|multiplikasjonen|multiplikasjonar
munk	munkane|munken|munkar
munn	munnar|munnane|munnen
munning	munningen|munningane|munninga|munningar
mur	murane|muren|murar
museum	musea|museet
musikalsk	musikalske
musikk	musikken
muskel	musklane|musklar|muskelen
muslim	muslimen|muslimane|muslimar
mutter	mutteren|mutterane|mutterar|mutrane|mutrar
mygg	myggane|myggen|myggar
mynt	mynten|myntane|myntar
myrde	myrdande|myrdar|myrda|myrdast
mysterium	mysteria|mysteriet
myte	mytar|mytane|myten
måke	måken|måkane|måkene|måkar|måker|måka
mål	målet|måla
målestokk	målestokkar|målestokkane|målestokken
målmann	målmannen|målmenn|målmennene
måltid	måltidet|måltida
måndag	måndagen|måndagane|måndagar
måse	måsane|måsen|måsar
måtte	må|måtta|mått
møbel	møbelet|møbla|møblane|møblar
mølle	møller|mølla|møllene
møne	møna|mønet
mørk	mørkaste|mørke|mørkast|mørkare|mørkt
mørke	mørket|mørkande|mørk|mørker|mørkast|mørkt|mørkte|mørka
mørketid	mørketidene|mørketida|mørketider
møte	møtet|møta
naken	naknast|naknare|nake|nakent|nakne|naknaste
nakke	nakken|nakkane|nakkar
nase	nasande|nasar|nasen|nasane|nasast|nasa
nasjon	nasjonane|nasjonar|nasjonen
nasjonal	nasjonalt|nasjonale
nasjonaldag	nasjonaldagane|nasjonaldagar|nasjonaldagen
nasjonalitet	nasjonalitetar|nasjonalitetane|nasjonaliteten
nasjonalpark	nasjonalparkane|nasjonalparken|nasjonalparkar
natt	natta|natter|nattene
natur	naturar|naturane|naturen
naturlov	naturlovane|naturlover|naturlova|naturloven|naturlovar|naturlovene
naud	naudene|nauder|nauda
navle	navlane|navlen|navlar
navlestreng	navlestrengen|navlestrengar|navlestrengane|navlestrenger|navlestrengene
nazisme	nazismen
nazist	nazisten|nazistar|nazistane
nazistisk	nazistiske
nebb	nebbet|nebbar|nebba|nebbane|nebben
nedbør	nedbøren
nederlag	nederlaga|nederlaget
nederlandsk	nederlandske|nederlandsken
nedgang	nedgangen|nedgangar|nedgangane
negativ	negativt|negative
nepe	nepene|nepa|neper
nerve	nervane|nerven|nervar
nervøs	nervøse|nervøst
nevø	nevøar|nevøane|nevøen
nitrogen	nitrogenet
nivå	nivået|nivåa
nomade	nomaden|nomadar|nomadane
nonne	nonner|nonna|nonnene
nordisk	nordiske
nordlys	nordlysa|nordlyset
nordmann	nordmennene|nordmannen|nordmenn
normal	normalt|normale
norrøn	norrønt|norrøne
norsk	norskast|norsken|norske|norskare|norskaste
notat	notatet|notata
note	notane|noten|notar
notisbok	notisbøkene|notisbøker|notisboka
nummer	nummera|nummeret
ny	nyaste|nyare|nytt|nye|nyast
nygift	nygifte
nymåne	nymånane|nymånar|nymånen
nynorsk	nynorsken
nyre	nyrer|nyra|nyrene|nyret
nysgjerrig	nysgjerrige
nyttår	nyttåra|nyttåret
nyttårsdag	nyttårsdagane|nyttårsdagar|nyttårsdagen
nåde	nåden
nål	nålene|nåla|nåler
nær	nært|nærare|nærast|nære|næraste
næringsrik	næringsrike|næringsrikt
nøkkel	nøklar|nøklane|nøkkelen
nøtt	nøtter|nøttene|nøtta
nøyaktig	nøyaktige
nøytral	nøytrale|nøytralt
objekt	objekta|objektet
objektiv	objektivet|objektiva
obligatorisk	obligatoriske
obo	oboen|oboar|oboane
offer	offera|offeret
offiser	offiserar|offiseren|offiserane
offisiell	offisielt|offisielle
ofre	ofrar|ofrande|ofrast|ofra
oksygen	oksygenet
olje	oljene|oljer|oljar|olja|oljane|oljen
oljefelt	oljefeltet|oljefelta
omelett	omelettar|omelettane|omeletten
omn	omnar|omnen|omnane
område	området|områda
omsyn	omsynet
onkel	onklane|onklar|onkelen
onsdag	onsdagane|onsdagar|onsdagen
operasjon	operasjonar|operasjonane|operasjonen
operette	operettane|operettar|operetten
oppdage	oppdagande|oppdaga|oppdagast|oppdagar
oppdrag	oppdraget|oppdraga
opphav	opphava|opphavet
opprør	opprøra|opprøret
oppskrift	oppskriftene|oppskrifta|oppskrifter
oppslagsverk	oppslagsverket|oppslagsverka
opptatt	opptatte|opptattare|opptattaste|opptattast
oppvask	oppvaskane|oppvaska|oppvaskar|oppvasken|oppvasket
oppvaskklut	oppvaskklutar|oppvaskkluten|oppvaskklutane
oppvaskmaskin	oppvaskmaskinane|oppvaskmaskinene|oppvaskmaskina|oppvaskmaskinar|oppvaskmaskinen|oppvaskmaskiner
optimisme	optimismen
optimist	optimisten|optimistar|optimistane
optimistisk	optimistiske
oransje	oransjen
orden	ordenar|ordenane|ordenen
ordinær	ordinære|ordinært
ordre	ordrar|ordren|ordrane
ordtak	ordtaka|ordtaket
organisasjon	organisasjonane|organisasjonen|organisasjonar
orgasme	orgasmane|orgasmar|orgasmen
orgel	orgelet|orgla
orientalsk	orientalske
orkan	orkanar|orkanen|orkanane
orkester	orkesteret|orkestera
ost	ostar|osten|ostane
overbefolkning	overbefolkninga
overflate	overflater|overflata|overflatene
overleve	overlever|overlev|overlevde|overlevande|overlevast|overlevd
oversikt	oversiktene|oversikter|oversikta
padde	padder|padda|paddene
pakke	pakkar|pakkene|pakken|pakkane|pakker|pakka
pakt	paktene|pakter|pakta
panikk	panikken
panne	panna|panner|pannene
pannekake	pannekaka|pannekaker|pannekakene
papegøye	papegøyane|papegøyen|papegøyar
papir	papira|papiret
par	paret|para
paradoks	paradokset|paradoksa
paraply	paraplyane|paraplyar|paraplyen
parasitt	parasittane|parasitten|parasittar
parfyme	parfymane|parfymen|parfymar
park	parkane|parken|parkar
parkeringsplass	parkeringsplassar|parkeringsplassane|parkeringsplassen
parlament	parlamentet|parlamenta
parodi	parodiar|parodiane|parodien
parti	partia|partiet
parykk	parykken|parykkane|parykkar
pasient	pasienten|pasientar|pasientane
pass	passet|passa
passasjer	passasjerar|passasjerane|passasjeren
patrulje	patruljane|patruljen|patruljar
pause	pausane|pausen|pausar
pave	paven|pavar|pavane
pedal	pedalar|pedalen|pedalane
pels	pelsane|pelsen|pelsar
pendel	pendlar|pendelen|pendlane
pengeskap	pengeskapet|pengeskapa
penis	penisar|penisen|penisane
penn	pennen|pennane|pennar
pensjonist	pensjonisten|pensjonistane|pensjonistar
perfekt	perfekte
periode	periodane|periodar|perioden
perle	perlene|perla|perler
permanent	permanente
perrong	perrongen|perrongane|perrongar
person	personane|personen|personar
perspektiv	perspektivet|perspektiva
pessimisme	pessimismen
pessimist	pessimisten|pessimistar|pessimistane
pessimistisk	pessimistiske
piano	pianoet|pianoa
piggsvin	piggsvinet|piggsvina
piggtråd	piggtrådar|piggtråden|piggtrådane
pigment	pigmentet|pigmenta
pil	pilen|pila|pilene|pilane|pilar|piler
pine	pint|pinte|pin|pinast|piner|pinande
pinse	pinsar|pinser|pinsen|pinsane|pinsene|pinsa
pipe	pipa|pipene|piper
pisk	piskane|pisken|piskar
plagg	plagga|plagget
plan	planet|planare|plant|planane|planen|planast|plana|planaste|plane|planar
planet	planetar|planeten|planetane
plankton	planktonet
plante	plantar|planten|plantane
plass	plassen|plassane|plassar
plassering	plasseringar|plasseringane|plasseringa
plast	plastane|plastar|plasten
plattform	plattformer|plattformene|plattforma
plog	plogar|plogen|plogane
plomme	plomma|plommene|plommer
pol	polar|polane|polen
polakk	polakkane|polakken|polakkar
politi	politiar|politien|politiane|politiet
politikk	politikkar|politikkane|politikken
politisk	politiske
polsk	polsken|polske
pornografi	pornografien
porselen	porselenet
portrett	portretta|portrettet
portugis	portugisane|portugisen|portugisar
portugisisk	portugisiske|portugisisken
porøs	porøst|porøse
pose	posane|posar|posen
posisjon	posisjonane|posisjonen|posisjonar
positiv	positive|positivt
post	postane|postar|posten
postboks	postboksar|postboksane|postboksen
postkontor	postkontora|postkontoret
postnummer	postnummera|postnummeret
potet	potetene|poteter|potetar|potetane|poteten|poteta
potte	potta|potter|pottene
potteplante	potteplanten|potteplantane|potteplanter|potteplantar|potteplanta|potteplantene
praktisk	praktiske
premie	premiane|premiar|premien
premiere	premieren|premierar|premierane
preposisjon	preposisjonar|preposisjonane|preposisjonen
presang	presangane|presangar|presangen
president	presidentane|presidenten|presidentar
presis	presist|presise
prest	prestar|prestane|presten
prestasjon	prestasjonar|prestasjonen|prestasjonane
prestisje	prestisjen
primitiv	primitivt|primitive
primær	primært|primære
prinsipiell	prinsipielle|prinsipielt
prinsipp	prinsippa|prinsippet
prioritet	prioritetar|prioriteten|prioritetane
pris	prisen|prisane|prisar
prisbevisst	prisbevisste
prisindeks	prisindeksar|prisindeksane|prisindeksen
prislapp	prislappane|prislappar|prislappen
privat	private
problem	problemet|problema
produksjon	produksjonane|produksjonar|produksjonen
produkt	produkta|produktet
produsent	produsenten|produsentar|produsentane
profesjonell	profesjonelle|profesjonelt
professor	professorane|professoren|professorar
profet	profetar|profetane|profeten
profil	profilen|profilar|profilane
program	programma|programmet
pronomen	pronomenet|pronomena
prosedyre	prosedyrar|prosedyrane|prosedyren
prosent	prosentar|prosentane|prosenten
prosjekt	prosjekta|prosjektet
prostituert	prostituerte
prostitusjon	prostitusjonen
protein	proteina|proteinet
protestant	protestanten|protestantar|protestantane
protestantisk	protestantiske
provins	provinsane|provinsar|provinsen
psykiater	psykiateren|psykiaterar|psykiaterane
psykiatri	psykiatrien
psykiatrisk	psykiatriske
psykolog	psykologen|psykologane|psykologar
psykologi	psykologiane|psykologiar|psykologien
pubertet	puberteten
publikasjon	publikasjonen|publikasjonar|publikasjonane
publikum	publikumet|publikummet
pulver	pulvera|pulveret
pumpe	pumpa|pumper|pumpene
punkt	punkta|punktet
punktskrift	punktskrifta
punktum	punktumet|punktuma
pupp	puppane|puppar|puppen
purre	purrast|purra|purrar|purren|purrande|purrane
pus	pusar|pusane|pusen
pynt	pynten
pyramide	pyramidane|pyramidar|pyramiden
påske	påskar|påskene|påskane|påsker|påsken|påska
påskedag	påskedagar|påskedagane|påskedagen
påskeegg	påskeegget|påskeegga
pære	pærene|pæra|pærer
pølse	pølser|pølsa|pølsene
rabarbra	rabarbraane|rabarbraen|rabarbraer|rabarbraar|rabarbraene
rabatt	rabattar|rabatten|rabattane
radar	radarar|radarane|radaren
radikal	radikalt|radikalet|radikala|radikale
radio	radioen|radioane|radioar
raffineri	raffineriet|raffineria
rakett	raketten|rakettar|rakettane
ramme	rammene|ramma|rammer
rand	rendene|randen|render|randane|randa
rapport	rapporten|rapportar|rapportane
rasere	raserte|raserande|raserast|raser|raserer|rasert
rask	raskt|raske|raskaste|raskast|raskare
ratt	rattet|ratta
reaksjon	reaksjonen|reaksjonane|reaksjonar
redaktør	redaktøren|redaktørar|redaktørane
referanse	referansar|referansane|referansen
refleksiv	refleksive|refleksivt
reform	reformer|reformene|reforma
regel	regelen|reglar|reglane
regelmessig	regelmessige
regime	regima|regimet
region	regionen|regionane|regionar
regjering	regjeringa|regjeringar|regjeringane
regn	regnet
regnboge	regnbogen|regnbogane|regnbogar
rein	reinar|reine|reinen|reinaste|reinare|reint|reinast|reinane
reinsdyr	reinsdyret|reinsdyra
reisemål	reisemålet|reisemåla
reklame	reklamar|reklamen|reklamane
rekne	reknar|reknande|reknast|rekna
rekord	rekordane|rekorden|rekordar
rektor	rektorane|rektorar|rektoren
relativ	relativt|relative
religion	religionen|religionar|religionane
religiøs	religiøst|religiøse
reparasjon	reparasjonen|reparasjonar|reparasjonane
reportasje	reportasjen|reportasjar|reportasjane
reporter	reporterane|reporterar|reporteren
representant	representanten|representantar|representantane
republikk	republikken|republikkane|republikkar
resepsjon	resepsjonar|resepsjonane|resepsjonen
reservedel	reservedelar|reservedelen|reservedelane
reservehjul	reservehjulet|reservehjula
ressurs	ressursar|ressursen|ressursane
restaurant	restaurantar|restaurantane|restauranten
resultat	resultata|resultatet
resymé	resyméa|resymeet|resyméet|resymea
retning	retninga|retningane|retningar
retningslinje	retningslinjer|retningslinja|retningslinjene
rett	rette|retter|rettene|rettar|retten|rettane
rettssal	rettssalen|rettssalar|rettssalane
rev	revet|reven|revane|reva|revar
revolusjon	revolusjonen|revolusjonar|revolusjonane
revolusjonær	revolusjonærar|revolusjonære|revolusjonærane|revolusjonært|revolusjonæren
revolver	revolverar|revolveren|revolverane
rik	rike|rikare|rikast|rikt|rikaste
rike	riket|rika
riksmål	riksmålet
ring	ringar|ringane|ringen
ringe	ringde|ringast|ringer|ring|ringt|ringande
ris	risen
risiko	risikoen|risikoane|risikoar
rivjern	rivjerna|rivjernet
ro	roa
robåt	robåtane|robåtar|robåten
rogn	rognar|rogner|rognane|rognene|rogna|rognen
rolle	roller|rolla|rollene
rom	rommet|romma|rommen
roman	romanar|romanane|romanen
rose	roser|rosa|rosene
rosin	rosinene|rosiner|rosina
rot	røtene|røter|rota
rotte	rotter|rotta|rottene
rovdyr	rovdyra|rovdyret
rug	rugen
rull	rullen|rullar|rullane
rullebane	rullebanar|rullebanen|rullebana|rullebaner|rullebanane|rullebanene
rullestol	rullestolen|rullestolar|rullestolane
rumen	rumenar|rumenen|rumenane
rumensk	rumensken|rumenske
rund	rundt|runde|rundare|rundaste|rundast
runke	runka|runkast|runkar|runkande
russisk	russisken|russiske
rust	rusta
rusten	ruste|rustne|rustent
rutine	rutinar|rutinane|rutinen
rygg	ryggar|ryggane|ryggene|ryggen|rygger
ryggsekk	ryggsekkane|ryggsekker|ryggsekkar|ryggsekkene|ryggsekken
rykte	ryktet|rykta
rytme	rytmen|rytmar|rytmane
rytmisk	rytmiske
rå	råe|råa|rærne|råaste|rær|rått|råast|råare
råd	råda|rådet
rådhus	rådhuset|rådhusa
råolje	råoljen|råoljar|råoljene|råolja|råoljer|råoljane
ræv	ræver|ræva|rævene
røyk	røyken
sabotasje	sabotasjen|sabotasjane|sabotasjar
sabotør	sabotøren|sabotørane|sabotørar
saft	safta|safter|saftene
saftig	saftigast|saftigare|saftige|saftigaste
sag	sager|sagene|saga
sagbruk	sagbruket|sagbruka
sak	sakene|saka|saker
sakne	saknande|sakna|saknar|saknast
saks	sakser|saksene|saksa
sal	salane|sala|salet|salen|salar
salami	salamien|salamiar|salamiane
salme	salmane|salmar|salmen
salmebok	salmebøkene|salmebøker|salmeboka
samarbeid	samarbeida|samarbeidet
samarbeide	samarbeidande|samarbeidd|samarbeider|samarbeid|samarbeidde|samarbeidast
samfunn	samfunnet|samfunna
samisk	samisken|samiske
samleie	samleiet|samleia
samling	samlingar|samlingane|samlinga
samtale	samtalen|samtalane|samtalar|samtaler|samtala|samtalene
sand	sanden
sandal	sandalane|sandalen|sandalar
sanddyne	sanddyner|sanddynene|sanddyna
sandpapir	sandpapiret
sandstrand	sandstranda|sandstrendene|sandstrender
sardin	sardinen|sardinar|sardinane
satire	satiren|satirar|satirane
sau	sauer|sauene|sauane|sauar|sauen
saus	sausar|sausane|sausen
scene	scener|scena|scenar|scenen|scenane|scenene
sebra	sebraer|sebraar|sebraene|sebraane|sebraen
segl	seglet|segla
sein	seinare|seine|seint|seinast|seinaste
sekk	sekker|sekkane|sekkene|sekken|sekkar
seksualitet	seksualiteten
seksuell	seksuelle|seksuelt
sektor	sektoren|sektorar|sektorane
sekund	sekundane|sekunden|sekundar|sekundet|sekunda
sekundær	sekundært|sekundære
selleri	selleriar|sellerien|selleriane
selskap	selskapet|selskapa
sement	sementen|sementar|sementane
semikolon	semikolonet|semikolona
sene	sena|sener|senene
seng	sengene|senger|sengs|senga
sengetid	sengetidene|sengetida|sengetider
senter	sentera|senteret
sentral	sentralar|sentrale|sentralt|sentralane|sentralen
sentrum	sentruma|sentrumet
separat	separate
seremoni	seremonien|seremoniar|seremoniane
servant	servantar|servantane|servanten
serviett	serviettar|serviettane|servietten
sesjon	sesjonar|sesjonane|sesjonen
sesong	sesongar|sesongen|sesongane
sete	seta|setet
setning	setningar|setningane|setninga
sex	sexen
shorts	shortsar|shortsen|shortsane
side	sidene|sida|sider
sigarett	sigarettane|sigaretten|sigarettar
signal	signalet|signala
signatur	signaturane|signaturen|signaturar
sikker	sikre|sikkert
sikt	sikter|sikten|sikta|siktene
sikte	sikta|siktet
silhuett	silhuettane|silhuettar|silhuetten
singel	singelane|singelen|singelar
sirkel	sirklar|sirkelen|sirklane
sirkulasjon	sirkulasjonar|sirkulasjonane|sirkulasjonen
sirkus	sirkusa|sirkuset
sirup	sirupen|sirupane|sirupar
sist	siste
sitron	sitronar|sitronen|sitronane
sitte	sitt|sittast|sat|sit|sittande|sete
sitteplass	sitteplassane|sitteplassar|sitteplassen
situasjon	situasjonane|situasjonen|situasjonar
sivil	sivilt|sivile
sivilisasjon	sivilisasjonar|sivilisasjonane|sivilisasjonen
sivilist	sivilistane|sivilisten|sivilistar
sjakk	sjakken
sjanse	sjansar|sjansen|sjansane
sjarmere	sjarmerande|sjarmer|sjarmerte|sjarmerast|sjarmert|sjarmerer
sjekk	sjekken|sjekkane|sjekkar
sjiraff	sjiraffane|sjiraffar|sjiraffen
sjokk	sjokka|sjokket
sjokolade	sjokoladar|sjokoladen|sjokoladane
sjuk	sjukaste|sjuke|sjukast|sjukt|sjukare
sjukdom	sjukdommane|sjukdomane|sjukdommen|sjukdommar|sjukdomar|sjukdomen
sjukehus	sjukehuset|sjukehusa
sjåfør	sjåføren|sjåførane|sjåførar
sjø	sjøs|sjøane|sjøen|sjøar
sjømann	sjømenn|sjømannen|sjømennene
skade	skadar|skaden|skadane
skal	skala|skalet
skandale	skandalen|skandalar|skandalane
skandinav	skandinavar|skandinaven|skandinavane
skandinavisk	skandinaviske
skatt	skatten|skattane|skattar
skepsis	skepsisen
skilt	skilta|skiltet
skinke	skinkene|skinka|skinker
skinn	skinna|skinnet
skisse	skisser|skissene|skissa
skive	skiva|skivene|skiver
skjegg	skjegget|skjegga
skjelett	skjelettet|skjeletta
skjerm	skjermen|skjermar|skjermane
skjorte	skjorter|skjorta|skjortene
skjønn	skjønne|skjønt
skjørt	skjørtet|skjørta
sko	skor|skoen|skorne|skoa
skogbruk	skogbruka|skogbruket
skole	skolane|skolen|skolar
skoleveske	skoleveska|skoleveskene|skolevesker
skolisse	skolissene|skolissa|skolisser
skotsk	skotske
skotte	skottar|skotten|skottane
skremme	skremmast|skremmer|skremde|skrem|skremmande|skremt
skribent	skribentane|skribenten|skribentar
skrift	skrifta|skriftene|skrifter
skriftspråk	skriftspråka|skriftspråket
skrive	skreiv|skriv|skrivast|skrivande
skrivebord	skrivebordet|skriveborda
skrivemaskin	skrivemaskiner|skrivemaskinar|skrivemaskinane|skrivemaskinene|skrivemaskinen|skrivemaskina
skrog	skroga|skroget
skrue	skruen|skruar|skruane
skrujern	skrujerna|skrujernet
skulder	skuldra|skuldrene|skuldrer
skulderblad	skulderbladet|skulderblada
skulle	skullande|skullast|skal|skull|skulla
skulptur	skulpturar|skulpturen|skulpturane
skyld	skylder|skyldene|skylda
skytevåpen	skytevåpena|skytevåpenet
skål	skåler|skålene|skåla
skøyte	skøyta|skøytene|skøyter
slagmark	slagmarker|slagmarka|slagmarkene
slalåm	slalåmen
slave	slavar|slavane|slaven
slaveri	slaveriet
slavisk	slaviske
slekt	slekta|slekter|slektene
slektning	slektningen|slektningane|slektningar
slektskap	slektskapar|slektskapane|slektskapet|slektskapen|slektskapa
slenge	slengast|slengde|slengt|slengande|slenger|sleng
slette	slettene|sletta|sletter
slips	slipsa|slipset
sludd	sluddet
sluse	slusene|slusa|sluser
slutt	sluttar|sluttane|slutten
slutte	sluttar|sluttande|slutta|sluttast
slå	slo|slåast|slående|slår|slått|slåande|slås
smak	smaken|smakar|smakane
smakfull	smakfulle|smakfullt
smal	smalast|smalare|smalt|smale|smalaste
smeltepunkt	smeltepunkta|smeltepunktet
smerte	smerter|smerta|smertene
smertefull	smertefulle|smertefullt
smil	smilane|smilar|smila|smilen|smilet
små	smått
smør	smøret
snakk	snakket
snakke	snakkande|snakkast|snakka|snakkar
snill	snilt|snille
snø	snøen
snøball	snøballane|snøballar|snøballen
snøfnugg	snøfnugget|snøfnugga
snømann	snømennene|snømenn|snømannen
snøplog	snøplogar|snøplogen|snøplogane
snøras	snøraset|snørasa
snøskred	snøskreda|snøskredet
sofa	sofaene|sofaane|sofaer|sofaar|sofaen
sokk	sokkane|sokken|sokkar
sol	soler|sola|solene
solbrent	solbrente
solbrille	solbrillene|solbriller|solbrilla
soldat	soldatar|soldatane|soldaten
solidaritet	solidariteten
solist	solisten|solistar|solistane
soloppgang	soloppgangar|soloppgangen|soloppgangane
sone	sonene|soner|sona
sopp	soppen|soppar|soppane
sort	sortane|sortar|sorten
sosialisme	sosialismen
sosiolog	sosiologane|sosiologen|sosiologar
sovepose	soveposen|soveposar|soveposane
soverom	soveromma|soverommet
spade	spaden|spadar|spadane
spak	spaken|spakar|spakane
spanjol	spanjolen|spanjolar|spanjolane
spansk	spansken|spanske
sparegris	sparegrisen|sparegriser|sparegrisane|sparegrisar|sparegrisene
spark	sparket|sparka
spedbarn	spedborna|spedbarnet|spedbarna|spedborn
spenning	spenninga|spenningar|spenningane
spent	spente
spesialist	spesialisten|spesialistane|spesialistar
spesiell	spesielle|spesielt
spindelvev	spindelveven|spindelvevane|spindelvevar|spindelvever|spindelvevene
spion	spionar|spionen|spionane
spiss	spissane|spissar|spissast|spist|spissare|spissaste|spisse|spissen
splitt	splittane|splitten|splittar
spontan	spontane|spontant
spor	sporet|spora
sprengstoff	sprengstoffa|sprengstoffet
språk	språka|språket
sprøyte	sprøyter|sprøyta|sprøytene
spytt	spyttet
spøk	spøkane|spøken|spøkar
spøke	spøk|spøker|spøkt|spøkande|spøkast|spøkte
stabil	stabile|stabilt
stabilitet	stabiliteten
stadion	stadiona|stadionet
stadium	stadia|stadiet
stamtre	stamtra|stamtret
standard	standardar|standardane|standarden
start	startane|starten|startar
stasjon	stasjonen|stasjonar|stasjonane
stasjonsvogn	stasjonsvognene|stasjonsvogner|stasjonsvogna
stat	statane|staten|statar
statist	statisten|statistane|statistar
statistikk	statistikken|statistikkane|statistikkar
statistisk	statistiske
statskupp	statskuppet|statskuppa
statsminister	statsministrane|statsministeren|statsministrar
statue	statuen|statuar|statuane
statussymbol	statussymbola|statussymbolet
stearinlys	stearinlysa|stearinlyset
steikepanne	steikepanna|steikepannene|steikepanner
steinblokk	steinblokka|steinblokker|steinblokken|steinblokkar|steinblokkene|steinblokkane
steinkast	steinkastet|steinkasta
steinras	steinraset|steinrasa
stele	stelane|stelast|stelande|stal|stel|stelen|stelar|stole
stemme	stemma|stemmer|stemmene
stereoanlegg	stereoanlegga|stereoanlegget
sterk	sterkt|sterkare|sterke|sterkaste|sterkast
stige	stigane|stigar|stigen
stilfull	stilfullt|stilfulle
stilig	stiligaste|stilige|stiligare|stiligast
stilling	stillinga|stillingane|stillingar
stim	stimen|stimar|stimane
stivelse	stivelsar|stivelsane|stivelsen
stjerne	stjerna|stjernene|stjerner
stoff	stoffa|stoffet
stol	stolane|stolen|stolar
stolt	stolte|stoltare|stoltast|stoltaste
stoppeklokke	stoppeklokkene|stoppeklokka|stoppeklokker
stor	stort|større|størst|store|største
storby	storbyen|storbyar|storbyane
storm	stormar|stormen|stormane
straffbar	straffbare|straffbart
strand	stranda|strendene|strender
strategi	strategiar|strategiane|strategien
strategisk	strategiske
strekning	strekningen|strekninga|strekningar|strekningane
streng	strengane|strengast|strenge|strengt|strengen|strengene|strenger|strengare|strengar|strengaste
struktur	strukturane|strukturen|strukturar
stråle	strålar|strålane|strålen
stråling	strålinga|strålingane|strålingar
strømpe	strømpa|strømper|strømpene
strømpebukse	strømpebuksene|strømpebuksa|strømpebukser
student	studenten|studentane|studentar
studere	studer|studerast|studerande|studert|studerer|studerte
studium	studiet|studia
stykke	stykket|stykka
styrke	styrkar|styrkane|styrken|styrkte|styrkt|styrkast|styrkande|styrk|styrker
stål	stålet
stålorm	stålormane|stålormen|stålormar
stålull	stålulla
støpsel	støpsla|støpselet
størrelse	størrelsane|størrelsar|størrelsen
støv	støvet
støvel	støvelen|støvlane|støvlar
substantiv	substantiva|substantivet
subtraksjon	subtraksjonar|subtraksjonen|subtraksjonane
sukker	sukkeret|sukkera
sukkerfri	sukkerfrie|sukkerfritt
suksess	suksessane|suksessen|suksessar
sum	suma|sumet
sunn	sunt|sunnaste|sunnare|sunnast|sunne
supermakt	supermakter|supermaktene|supermakta
suppe	supper|suppa|suppene
suvenir	suveniren|suvenirane|suvenirar
svak	svakare|svake|svakast|svakaste|svakt
svale	svaler|svala|svalene
svane	svanene|svana|svaner
svanger	svangre|svangert
svangerskap	svangerskapar|svangerskapen|svangerskapane|svangerskapet|svangerskapa
svart	svarte|svartaste|svartast|svartare
svarteliste	svartelistene|svartelista|svartelister
sveitsisk	sveitsiske
svensk	svensken|svenske
svenske	svensken|svenskane|svenskar
sverd	sverda|sverdet
sverm	svermar|svermen|svermane
svigerfar	svigerfedrane|svigerfaren|svigerfedrar
svigerinne	svigerinner|svigerinnene|svigerinna
svigermor	svigermødrene|svigermora|svigermødrer
svike	svikande|sveik|svik|svikast
svindel	svindelen|svindlane|svindlar
sviske	sviskene|sviska|svisker
svoger	svograr|svogeren|svograne
svovel	svovelen|svovelet
svær	sværaste|sværare|sværast|svære|svært
syfilis	syfilisen
sykkel	syklane|syklar|sykkelen
sykkelsti	sykkelstien|sykkelstiane|sykkelstiar
syklist	syklisten|syklistar|syklistane
sylinder	sylindrane|sylindrar|sylinderen
syltetøy	syltetøya|syltetøyet
symaskin	symaskina|symaskinar|symaskinen|symaskinane|symaskinene|symaskiner
symbol	symbolet|symbola
symbolsk	symbolske
symptom	symptomet|symptoma
syn	syner|synet|syna|synene
synd	synder|synda|syndene
syndebukk	syndebukken|syndebukkane|syndebukkar
synge	syng|song|sunge|syngande|syngast
syntetisk	syntetiske
synål	synålene|synåler|synåla
syre	syrer|syrene|syra
system	systemet|systema
systematisk	systematiske
så	såast|sådd|sådde|såande|sår
såpe	såpa|såper|såpene
sår	såre|såret|såra|sårt
sårbar	sårbare|sårbart
søke	søkast|søkte|søkt|søkande|søk|søker
søle	søla
sølv	sølvet|sølva
søndag	søndagen|søndagar|søndagane
søppel	søpla|søppelet
søring	søringar|søringane|søringen
søsken	søskena|søskenet
søster	søstera|søstrer|søstrene
søt	søte|søtaste|søtast|søtt|søtare
søvn	søvne|søvnen
søvnig	søvnige
ta	teke|takande|tar|takast|tok|tek|tatt
tabell	tabellar|tabellen|tabellane
tablett	tablettane|tablettar|tabletten
tak	taket|taka
takstein	taksteinar|taksteinen|taksteinane
taktfull	taktfulle|taktfullt
talent	talenta|talentet
tallerken	tallerkenen|tallerkenane|tallerkenar
talsmann	talsmennene|talsmenn|talsmannen
tam	tamme|tamt
tank	tanken|tankane|tankar
tanke	tanken|tankar|tankast|tankande|tankane|tanka
tankefull	tankefulle|tankefullt
tankskip	tankskipet|tankskipa
tann	tenner|tanna|tennene
tannbørste	tannbørstane|tannbørsten|tannbørstar
tannhjul	tannhjula|tannhjulet
tannkrem	tannkremane|tannkremar|tannkremen
tannlege	tannlegen|tannlegar|tannlegane
tannverk	tannverken
tante	tantene|tanta|tanter
tap	tapa|tapet
tape	tapa|tapane|tapar|tapast|tapande|tapen
tapet	tapeta|tapetet
tatovere	tatover|tatoverer|tatovert|tatoverast|tatoverande|tatoverte
tatovering	tatoveringane|tatoveringar|tatoveringa
taus	tause|taust
tavle	tavla|tavlene|tavler
taxi	taxiar|taxien|taxiane
te	teen
teater	teateret|teatera
teaterstykke	teaterstykket|teaterstykka
tefat	tefata|tefatet
tekanne	tekanner|tekanna|tekannene
teknikk	teknikken|teknikkane|teknikkar
teknisk	tekniske
teknologi	teknologiane|teknologiar|teknologien
teknologisk	teknologiske
tekst	teksta|teksten|tekstane|tekstar|tekstene|tekster
tekstil	tekstilen|tekstilar|tekstilet|tekstila|tekstilane
telefon	telefonar|telefonen|telefonane
tema	temaet|temaa
temperatur	temperaturane|temperaturar|temperaturen
tempo	tempoa|tempoet
tendens	tendensen|tendensane|tendensar
tenke	tenkte|tenkast|tenk|tenker|tenkt|tenkande
tennis	tennisen
tennisbane	tennisbanene|tennisbanane|tennisbanar|tennisbanen|tennisbaner|tennisbana
tennplugg	tennpluggane|tennpluggen|tennpluggar
tenåring	tenåringar|tenåringane|tenåringen
teolog	teologar|teologane|teologen
teologi	teologien|teologiar|teologiane
teologisk	teologiske
teoretisk	teoretiske
teori	teorien|teoriane|teoriar
teppe	teppa|teppet
termometer	termometeret|termometera
termostat	termostatane|termostatar|termostaten
terning	terningen|terningar|terningane
terpentin	terpentinet|terpentinen
terrasse	terrassane|terrassar|terrassen
terreng	terrenga|terrenget
territorium	territoriet|territoria
terrorist	terroristar|terroristen|terroristane
teskei	teskeia|teskeier|teskeiene
tett	tettast|tettare|tette|tettaste
tid	tide|tidene|tida|tider
tidsskrift	tidsskrifter|tidsskriftet|tidsskriftene|tidsskrifta
tiger	tigerane|tigeren|tigerar
tilfeldig	tilfeldige
tilfelle	tilfella|tilfellet
tillegg	tillegga|tillegget
tilsetning	tilsetningane|tilsetninga|tilsetningar
tilstand	tilstanden|tilstandar|tilstandane
time	timar|timen|timane
ting	tingen|tinga|tinget
tinn	tinnet
tips	tipsa|tipset
tittel	titlar|titlane|tittelen
tiår	tiåret|tiåra
tjern	tjerna|tjernet
toalett	toalettet|toaletta
toalettpapir	toalettpapiret
tobakk	tobakkane|tobakken|tobakkar
tog	toget|toga
tolk	tolken|tolkar|tolkane
tom	tommare|tommast|tomme|tommaste|tomt
tomat	tomatane|tomaten|tomatar
tomatpuré	tomatpuréen|tomatpureen
tomme	tommar|tommen|tommane
tommel	tomlane|tomlar|tommelen
tommelfinger	tommelfingrar|tommelfingrane|tommelfingeren
tone	tonane|tonar|tonen
tonn	tonna|tonnet
topp	toppen|toppane|toppar
torn	tornane|tornen|tornar
torsdag	torsdagane|torsdagar|torsdagen
torsk	torskar|torskane|torsken
tortur	torturar|torturane|torturen
torv	torvene|torver|torva
tosk	tosken|toskane|toskar
total	totalt|totale
totalitær	totalitært|totalitære
tradisjon	tradisjonen|tradisjonane|tradisjonar
tradisjonell	tradisjonelle|tradisjonelt
trafikk	trafikken
traktor	traktoren|traktorar|traktorane
transport	transportar|transportane|transporten
transportmiddel	transportmiddelet|transportmidla
tredel	tredelen|tredelar|tredelane
tredemølle	tredemøller|tredemøllene|tredemølla
tredjedel	tredjedelar|tredjedelane|tredjedelen
trehus	trehuset|trehusa
trekant	trekantar|trekantane|trekanten
trene	trenast|trenar|trena|trenande
trenge	trenger|trong|trengde|trunge|trengast|trengt|treng|trengande
trening	treningane|treningar|treninga
tribune	tribunar|tribunen|tribunane
trikk	trikken|trikkar|trikkane
trilling	trillingen|trillingane|trillingar
trio	trioane|trioar|trioen
triumf	triumfen|triumfar|triumfane
troll	trolla|trollet
trolldom	trolldomen
tromme	trommer|trommene|tromma
trommehinne	trommehinnene|trommehinna|trommehinner
trommestikke	trommestikkene|trommestikker|trommestikka
trompet	trompeten|trompetane|trompetar
tropisk	tropiske
tru	truande|truene|trudd|trua|truer|trur|trudde|truast
trufast	trufaste
trussel	truslar|truslane|trusselen
truverdig	truverdigare|truverdige|truverdigast|truverdigaste
trykk	trykka|trykket
trykkfeil	trykkfeilen|trykkfeila
tråd	trådar|tråden|trådane
trøbbel	trøbbelet
tsjekkisk	tsjekkisken|tsjekkiske
tuberkulose	tuberkulosen
tulipan	tulipanar|tulipanen|tulipanane
tung	tyngst|tyngre|tungt|tunge|tyngste
tunge	tunger|tungene|tunga
tunnel	tunnelane|tunnelen|tunnelar
tur	turane|turen|turar
turisme	turismen
turist	turistar|turistane|turisten
tusj	tusjar|tusjane|tusjen
tut	tutet|tutar|tutane|tuten|tuta
tvilling	tvillingane|tvillingen|tvillingar
tvist	tvistar|tvistane|tvisten
tyde	tyd|tydast|tydande|tydde|tydd|tyder
tygge	togge|tyggande|tyggast|togg|tygg
tyggegummi	tyggegummiar|tyggegummien|tyggegummiane
tynn	tynnare|tynnaste|tynne|tynt|tynnast
type	typen|typar|typane
typisk	typiske
tyrann	tyrannane|tyrannen|tyrannar
tyrkisk	tyrkiske|tyrkisken
tysk	tyske|tysken
tå	tærne|tåa|tær
tåke	tåka|tåker|tåkene
tåre	tårer|tåra|tårene
tårn	tårna|tårnet
tøff	tøffaste|tøffast|tøft|tøffare|tøffe
tøffel	tøflane|tøflar|tøffelen
tømmer	tømmeret
tømmerstokk	tømmerstokkar|tømmerstokkane|tømmerstokken
tørke	tørken|tørkane|tørkar
tørketrommel	tørketromlar|tørketromlane|tørketrommelen
tørr	tørraste|tørrast|tørre|tørt|tørrare
tørst	tørste|tørstaste|tørstast|tørstare
tørste	tørsten
ubåt	ubåtane|ubåtar|ubåten
uformell	uformelle|uformelt
ufullstendig	ufullstendige
ugift	ugifte
ugle	ugler|ugla|uglene
uheldig	uheldige
ukjent	ukjente
uklar	uklart|uklare
ulik	ulike|ulikt
ull	ulla
ultrafiolett	ultrafiolette
ulv	ulvane|ulvar|ulven
ulykke	ulykkene|ulykka|ulykker
umoden	umode|umodent|umodne
umyndig	umyndige
under	underet|undera
underernæring	underernæringa
undergang	undergangar|undergangane|undergangen
underjordisk	underjordiske
understell	understellet|understella
undersøke	undersøkt|undersøkte|undersøker|undersøkast|undersøkande|undersøk
undertøy	undertøyet
undervisning	undervisningane|undervisninga|undervisningar
undulat	undulaten|undulatar|undulatane
ung	unge|yngste|yngre|yngst|ungt
ungar	ungaren|ungarane|ungarar
ungarsk	ungarske|ungarsken
ungdom	ungdommane|ungdommen|ungdomen|ungdomane|ungdomar|ungdommar
unge	ungar|ungen|ungane
uniform	uniforma|uniformene|uniformer
univers	universet|universa
universell	universelle|universelt
universitet	universiteta|universitetet
unntak	unntaket|unntaka
ur	uret|ura
urin	urinen
uro	uroa|uroene|uroer
usikker	usikkert|usikre
uskyldig	uskyldige
utdanning	utdanningar|utdanningane|utdanninga
utdrag	utdraget|utdraga
utfordre	utfordrande|utfordra|utfordrar|utfordrast
utfordring	utfordringar|utfordringa|utfordringane
utforming	utforminga|utformingar|utformingane
utforske	utforskar|utforska|utforskande|utforskast
utgang	utgangen|utgangane|utgangar
utgift	utgiftene|utgifter|utgifta
utland	utlandet|utlanda
utløp	utløpa|utløpet
utnytte	utnyttande|utnyttast|utnytta|utnyttar
utslett	utslettet|utsletta
utslette	utsletta|utslettast|utslettar|utslettande
utstilling	utstillingar|utstillingane|utstillinga
utstyr	utstyret
utsyn	utsyner|utsyna|utsynene|utsynet
uttrykk	uttrykka|uttrykket
utvikle	utviklast|utviklande|utviklar|utvikla
utvikling	utviklinga|utviklingar|utviklingane
vaffel	vaflane|vaffelen|vaflar
vakker	vakrare|vakre|vakkert|vakrast|vakraste
vaksine	vaksinar|vaksinen|vaksinane
vakt	vakter|vakta|vaktene
vakuum	vakuumet|vakuuma
valuta	valutaer|valutaen|valutaar|valutaane|valutaene
valutakurs	valutakursar|valutakursen|valutakursane
vandre	vandrast|vandrar|vandra|vandrande
vante	vanten|vantane|vantar
vare	varene|vara|varer
varemerke	varemerket|varemerka
variasjon	variasjonar|variasjonen|variasjonane
varm	varmaste|varme|varmast|varmare|varmt
varme	varmen
varsel	varsla|varselet
vase	vasar|vasane|vasen
vaskemaskin	vaskemaskinane|vaskemaskiner|vaskemaskinen|vaskemaskinar|vaskemaskina|vaskemaskinene
vatn	vatna|vatnet
ved	veden
vedde	veddande|veddar|veddast|vedda
veg	vegen|vegane|vegar
vegetasjon	vegetasjonane|vegetasjonen|vegetasjonar
vegg	vegger|veggene|veggen|veggar|veggane
veik	veike|veikaste|veikt|veikare|veikast
vekke	vekkast|vekkande|vekk|vekker|vekte|vekt
vekt	vektene|vekter|vekta
vektløfting	vektløftinga
velstand	velstanden
vendepunkt	vendepunktet|vendepunkta
veng	vengene|venger|vengen|vengane|vengar
venn	venner|vennane|vennene|vennar|vennen
vennskap	vennskapane|vennskapar|vennskapen|vennskapa|vennskapet
vente	ventar|ventast|ventande|venta
venteliste	ventelister|ventelista|ventelistene
ventil	ventilane|ventilen|ventilar
veps	vepsane|vepsar|vepsen
veranda	verandaene|verandaane|verandaar|verandaer|verandaen
verb	verba|verbet
verdi	verdiar|verdien|verdiane
verdifull	verdifullt|verdifulle
verje	verjar|verjene|verjast|vart|varde|ver|verja|verjer|verjande
verktøy	verktøya|verktøyet
verktøykasse	verktøykassa|verktøykassane|verktøykassene|verktøykassar|verktøykasser|verktøykassen
vern	vernet|verna
verne	verna|vernast|vernar|vernande
verneplikt	verneplikta
versjon	versjonar|versjonane|versjonen
vert	vertar|vertane|verten
veske	veskene|vesker|veska
vest	vestar|vestane|vesten
veto	vetoa|vetoet
vibrasjon	vibrasjonane|vibrasjonar|vibrasjonen
vid	vide|vidast|vidt|vidare|vidaste
video	videoar|videoen|videoane
vik	vika|viker|vikene|vikar|vikane
viking	vikingen|vikingane|vikingar
viktig	viktigare|viktige|viktigaste|viktigast
vilje	vil|ville|vilja|viljast|viljande
vill	villare|vilt|ville|villaste|villast
villdyr	villdyra|villdyret
villsvin	villsvina|villsvinet
vind	vinden|vindar|vindane
vinkel	vinkelen|vinklar|vinklane
vinter	vinteren|vintrane|vintrar
virus	virusa|viruset
visdomstann	visdomstannene|visdomstanna|visdomstanner
visepresident	visepresidenten|visepresidentane|visepresidentar
visitt	visitten|visittane|visittar
visittkort	visittkortet|visittkorta
visp	vispen|vispane|vispar
viss	visse|visst
visum	visumet|visuma
vital	vitalt|vitale
vitamin	vitamina|vitaminet
vite	veit|vit|visst|vitast|vitande|visste
vitne	vitnet|vitna
vits	vitsen|vitsar|vitsane
vitskap	vitskapane|vitskapar|vitskapen
vodka	vodkaen
vogn	vogner|vogna|vognene
vokal	vokalar|vokalane|vokalen
vokalist	vokalisten|vokalistane|vokalistar
voks	voksen|voksane|voksar|vokset|voksa
volum	volumet|voluma
vott	vottar|votten|vottane
vrak	vraket|vraka
vulkan	vulkanen|vulkanar|vulkanane
vurdering	vurderinga|vurderingar|vurderingane
våpen	våpenet|våpena
vår	våren|vårane|vårar
væpne	væpna|væpnast|væpnande|væpnar
væske	væsker|væska|væskene
watt	watten|wattane
wienerbrød	wienerbrøda|wienerbrødet
yoghurt	yoghurten|yoghurtane|yoghurtar
yrke	yrka|yrket
ytst	ytste
zoologi	zoologien
å	åene|åa|åer
åker	åkrar|åkrane|åkeren
ål	ålane|ålar|ålen
ånd	ånda|åndene|ånder
år	årane|årene|årar|året|årer|åra
åre	årer|åra|årene
åremål	åremålet|åremåla
årsak	årsaker|årsakene|årsaka
årstid	årstidene|årstida|årstider
ås	åsen|åsar|åsane
åsyn	åsynet|åsyna
ære	æra
øgle	øglene|øgler|øgla
økonom	økonomen|økonomane|økonomar
økonomi	økonomiane|økonomiar|økonomien
økonomisk	økonomiske
øks	øksar|økser|øksane|øksene|øksa
øl	ølet
ønske	ønskte|ønskande|ønska|ønskt|ønsk|ønsket|ønsker|ønskast
ønskeliste	ønskelistene|ønskelista|ønskelister
ørken	ørkenen|ørkenar|ørkenane
ørliten	ørvesle|ørlite|ørsmå|ørsmåe|ørlitle
ørn	ørnane|ørnen|ørnene|ørnar|ørner|ørna
øvre	øvste|øvst
øvst	øvste
øydelegge	øydela|øydeleggast|øydelegg|øydeleggande|øydelagt
