偏旁	piānpáng<br>RADICALS HOMEPAGE<br>①<br>⼀ · ⼁ · ⼂ · ⼃ · ⼄ · ⼅<br>②<br>⼆ · ⼇ · ⼈ · ⼉ · ⼊ · ⼋ · ⼌ · ⼍ · ⼎ · ⼏ · ⼐ · ⼑ · ⼒ · ⼓ · ⼔ · ⼕ · ⼖ · ⼗ · ⼘ · ⼙ · ⼚ · ⼛ · ⼜<br>③<br>⼝ · ⼞ · ⼟ · ⼠ · ⼡ · ⼢ · ⼣ · ⼤ · ⼥ · ⼦ · ⼧ · ⼨ · ⼩ · ⼪ · ⼫ · ⼬ · ⼭ · ⼮ · ⼯ · ⼰ · ⼱ · ⼲ · ⼳ · ⼴ · ⼵ · ⼶ · ⼷ · ⼸ · ⼹ · ⼺ · ⼻<br>④<br>⼼ · ⼽ · ⼾ · ⼿ · ⽀ · ⽁ · ⽂ · ⽃ · ⽄ · ⽅ · ⽆ · ⽇ · ⽈ · ⽉ · ⽊ · ⽋ · ⽌ · ⽍ · ⽎ · ⽏ · ⽐ · ⽑ · ⽒ · ⽓ · ⽔ · ⽕ · ⽖ · ⽗ · ⽘ · ⽙ · ⽚ · ⽛ · ⽜ · ⽝<br>⑤<br>⽞ · ⽟ · ⽠ · ⽡ · ⽢ · ⽣ · ⽤ · ⽥ · ⽦ · ⽧ · ⽨ · ⽩ · ⽪ · ⽫ · ⽬ · ⽭ · ⽮ · ⽯ · ⽰ · ⽱ · ⽲ · ⽳ · ⽴<br>⑥<br>⽵ · ⽶ · ⽷ · ⽸ · ⽹ · ⽺ · ⽻ · ⽼ · ⽽ · ⽾ · ⽿ · ⾀ · ⾁ · ⾂ · ⾃ · ⾄ · ⾅ · ⾆ · ⾇ · ⾈ · ⾉ · ⾊ · ⾋ · ⾌ · ⾍ · ⾎ · ⾏ · ⾐ · ⾑<br>⑦<br>⾒ · ⾓ · ⾔ · ⾕ · ⾖ · ⾗ · ⾘ · ⾙ · ⾚ · ⾛ · ⾜ · ⾝ · ⾞ · ⾟ · ⾠ · ⾡ · ⾢ · ⾣ · ⾤ · ⾥<br>⑧<br>⾦ · ⾧ · ⾨ · ⾩ · ⾪ · ⾫ · ⾬ · ⾭ · ⾮<br>⑨<br>⾯ · ⾰ · ⾱ · ⾲ · ⾳ · ⾴ · ⾵ · ⾶ · ⾷ · ⾸ · ⾹<br>⑩<br>⾺ · ⾻ · ⾼ · ⾽ · ⾾ · ⾿ · ⿀ · ⿁<br>⑪<br>⿂ · ⿃ · ⿄ · ⿅ · ⿆ · ⿇<br>⑫<br>⿈ · ⿉ · ⿊ · ⿋<br>⑬<br>⿌ · ⿍ · ⿎ · ⿏<br>⑭<br>⿐ · ⿑<br>⑮<br>⿒<br>⑯<br>⿓ · ⿔<br>⑰<br>⿕<br>WITH NAMES 有名字<br>⼀ · ⼂ · ⼇ · ⼈ · ⼉ · ⼊ · ⼋ · ⼌ · ⼍ · ⼎ · ⼏ · ⼐ · ⼑ · ⼒ · ⼓ · ⼔ · ⼕ · ⼗ · ⼙ · ⼚ · ⼛ · ⼜ · ⼝ · ⼞ · ⼟ · ⼠ · ⼡ · ⼣ · ⼤ · ⼥ · ⼦ · ⼧ · ⼨ · ⼩ · ⼫ · ⼭ · ⼯ · ⼱ · ⼲ · ⼴ · ⼵ · ⼶ · ⼸ · ⼺ · ⼻ · ⼼ · ⼽ · ⼾ · ⼿ · ⽁ · ⽄ · ⽅ · ⽇ · ⽉ · ⽊ · ⽋ · ⽌ · ⽎ · ⽔ · ⽕ · ⽖ · ⽙ · ⽜ · ⽝ · ⽟ · ⽥ · ⽦ · ⽧ · ⽨ · ⽩ · ⽪ · ⽫ · ⽬ · ⽯ · ⽰ · ⽲ · ⽳ · ⽴ · ⽵ · ⽶ · ⽷ · ⽹ · ⽺ · ⽻ · ⽼ · ⽿ · ⾆ · ⾈ · ⾉ · ⾋ · ⾍ · ⾐ · ⾒ · ⾔ · ⾙ · ⾛ · ⾜ · ⾞ · ⾟ · ⾡ · ⾢ · ⾣ · ⾥ · ⾦ · ⾨ · ⾩ · ⾫ · ⾬ · ⾭ · ⾴ · ⾷ · ⾺ · ⿃
一	yī<br>Variant of radical ⼀ (<b>one</b>)<br>EXAMPLES 王·丁·七·三<br><br>HOMEPAGE ► 偏旁
一字旁	yīzìpáng<br>Name of radical number 1 ⼀<br>MEANING <b>one</b><br>EXAMPLES 王·丁·七·三<br><br>HOMEPAGE ► 偏旁
⼀	yī<br>Kangxi radical number 1<br>NAME 一字旁 yīzìpáng<br>VARIANTS 一<br>STANDALONE 一<br>MEANING <b>one</b><br>EXAMPLES 王·丁·七·三<br>RANK 88.5%<br>DISTINGHUISH FROM 乛·亠·冖·宀<br>NOTES <i> Characters are classified here when they have a horizontal stroke and don't fit under any other radicals</i><br><br>HOMEPAGE ► 偏旁
丨	gǔn<br>Variant of radical ⼁ (<b>line</b>)<br>EXAMPLES 十·中·串·丰<br><br>HOMEPAGE ► 偏旁
⼁	gǔn<br>Kangxi radical number 2<br>NAME  <br>VARIANTS 丨<br>MEANING <b>line</b><br>EXAMPLES 十·中·串·丰<br>RANK 66.3%<br>DISTINGHUISH FROM 亅<br>NOTES <i> Now simply called shu4 - 竖, which means vertical stroke, see gun3</i><br><br>HOMEPAGE ► 偏旁
⺀	zhǔ<br>Variant of radical ⼂ (<b>dot</b>)<br>EXAMPLES 丸·凡·丹·户<br><br>HOMEPAGE ► 偏旁
丶	zhǔ<br>Variant of radical ⼂ (<b>dot</b>)<br>EXAMPLES 丸·凡·丹·户<br><br>HOMEPAGE ► 偏旁
丶字旁	zhǔzìpáng<br>Name of radical number 3 ⼂<br>MEANING <b>dot</b><br>EXAMPLES 丸·凡·丹·户<br><br>HOMEPAGE ► 偏旁
⼂	zhǔ<br>Kangxi radical number 3<br>NAME 丶字旁 zhǔzìpáng<br>VARIANTS ⺀·丶<br>MEANING <b>dot</b><br>EXAMPLES 丸·凡·丹·户<br>RANK 63.1%<br><br>HOMEPAGE ► 偏旁
丿	piě<br>Variant of radical ⼃ (<b>slash</b>)<br>EXAMPLES 乂·乃·久·八<br><br>HOMEPAGE ► 偏旁
乀	piě<br>Variant of radical ⼃ (<b>slash</b>)<br>EXAMPLES 乂·乃·久·八<br><br>HOMEPAGE ► 偏旁
乁	piě<br>Variant of radical ⼃ (<b>slash</b>)<br>EXAMPLES 乂·乃·久·八<br><br>HOMEPAGE ► 偏旁
⼃	piě<br>Kangxi radical number 4<br>NAME  <br>VARIANTS 丿·乀·乁<br>MEANING <b>slash</b><br>EXAMPLES 乂·乃·久·八<br>RANK 76.3%<br>NOTES <i> general stroke, sometimes means falling</i><br><br>HOMEPAGE ► 偏旁
⺂	yǐ<br>Variant of radical ⼄ (<b>second</b>)<br>EXAMPLES 九·乞·也<br><br>HOMEPAGE ► 偏旁
⺃	yǐ<br>Variant of radical ⼄ (<b>second</b>)<br>EXAMPLES 九·乞·也<br><br>HOMEPAGE ► 偏旁
⺄	yǐ<br>Variant of radical ⼄ (<b>second</b>)<br>EXAMPLES 九·乞·也<br><br>HOMEPAGE ► 偏旁
乙	yǐ<br>Variant of radical ⼄ (<b>second</b>)<br>EXAMPLES 九·乞·也<br><br>HOMEPAGE ► 偏旁
乚	yǐ<br>Variant of radical ⼄ (<b>second</b>)<br>EXAMPLES 九·乞·也<br><br>HOMEPAGE ► 偏旁
乛	yǐ<br>Variant of radical ⼄ (<b>second</b>)<br>EXAMPLES 九·乞·也<br><br>HOMEPAGE ► 偏旁
⼄	yǐ<br>Kangxi radical number 5<br>NAME  <br>VARIANTS ⺂·⺃·⺄·乙·乚·乛<br>STANDALONE 乙<br>MEANING <b>second</b><br>EXAMPLES 九·乞·也<br>MNEMONIC <i> possibly represents a sprout</i><br>RANK 52.7%<br><br>HOMEPAGE ► 偏旁
亅	jué<br>Variant of radical ⼅ (<b>hook</b>)<br>EXAMPLES 了·矛·事<br><br>HOMEPAGE ► 偏旁
𠄌	jué<br>Variant of radical ⼅ (<b>hook</b>)<br>EXAMPLES 了·矛·事<br><br>HOMEPAGE ► 偏旁
⼅	jué<br>Kangxi radical number 6<br>NAME  <br>VARIANTS 亅·𠄌<br>MEANING <b>hook</b><br>EXAMPLES 了·矛·事<br>RANK 44.4%<br>DISTINGHUISH FROM 丨<br><br>HOMEPAGE ► 偏旁
二	èr<br>Variant of radical ⼆ (<b>two</b>)<br>EXAMPLES 貳·于·云·些<br><br>HOMEPAGE ► 偏旁
⼆	èr<br>Kangxi radical number 7<br>NAME  <br>VARIANTS 二<br>STANDALONE 二<br>MEANING <b>two</b><br>EXAMPLES 貳·于·云·些<br>RANK 74.6%<br><br>HOMEPAGE ► 偏旁
亠	tóu<br>Variant of radical ⼇ (<b>lid</b>)<br>EXAMPLES 方·亡·亢·交<br><br>HOMEPAGE ► 偏旁
六字头	lìuzìtóu<br>Name of radical number 8 ⼇<br>MEANING <b>lid</b><br>EXAMPLES 方·亡·亢·交<br><br>HOMEPAGE ► 偏旁
⼇	tóu<br>Kangxi radical number 8<br>NAME 六字头 lìuzìtóu<br>VARIANTS 亠<br>MEANING <b>lid</b><br>EXAMPLES 方·亡·亢·交<br>RANK 75.3%<br>DISTINGHUISH FROM 一·冖·宀·乛<br>NOTES <i> known in chinese as “点横” or “文字头”. Only a couple characters relate to any concept of cover or lid, a few more relate to the idea of a head as something up above. </i><br><br>HOMEPAGE ► 偏旁
⺅	rén<br>Variant of radical ⼈ (<b>man</b>)<br>EXAMPLES 你·什·仁·仇<br><br>HOMEPAGE ► 偏旁
人	rén<br>Variant of radical ⼈ (<b>man</b>)<br>EXAMPLES 你·什·仁·仇<br><br>HOMEPAGE ► 偏旁
亻	rén<br>Variant of radical ⼈ (<b>man</b>)<br>EXAMPLES 你·什·仁·仇<br><br>HOMEPAGE ► 偏旁
单立人	dānlìrén<br>Name of radical number 9 ⼈<br>MEANING <b>man</b><br>EXAMPLES 你·什·仁·仇<br><br>HOMEPAGE ► 偏旁
单人旁	dānrénpáng<br>Name of radical number 9 ⼈<br>MEANING <b>man</b><br>EXAMPLES 你·什·仁·仇<br><br>HOMEPAGE ► 偏旁
⼈	rén<br>Kangxi radical number 9<br>NAME 单立人 dānlìrén·单人旁 dānrénpáng<br>VARIANTS ⺅·人·亻<br>STANDALONE 人<br>MEANING <b>man</b><br>EXAMPLES 你·什·仁·仇<br>MNEMONIC <i> This is a simple stick figure, or a pair of legs</i><br>RANK 75.3%<br>DISTINGHUISH FROM 入,八<br>NOTES <i> One of the most common radicals, typically used in characters representing human attributes or actions that man undertakes; Modern dictionaries group 人 and 入 together</i><br><br>HOMEPAGE ► 偏旁
儿	ér<br>Variant of radical ⼉ (<b>son, legs</b>)<br>EXAMPLES 兒·兀·允·元<br><br>HOMEPAGE ► 偏旁
儿座底	érzuòdǐ<br>Name of radical number 10 ⼉<br>MEANING <b>son, legs</b><br>EXAMPLES 兒·兀·允·元<br><br>HOMEPAGE ► 偏旁
⼉	ér<br>Kangxi radical number 10<br>NAME 儿座底 érzuòdǐ<br>VARIANTS 儿<br>STANDALONE 儿<br>MEANING <b>son, legs</b><br>EXAMPLES 兒·兀·允·元<br>MNEMONIC <i> Depicts the two legs of a person.   Few characters actually represent this meaning.</i><br>RANK 79.1%<br>NOTES <i> Also known as the LEGS radical due to ancient meaning.  Known now as the short form of 兒.</i><br><br>HOMEPAGE ► 偏旁
入	rù<br>Variant of radical ⼊ (<b>enter</b>)<br>EXAMPLES 內·全·兩·汆<br><br>HOMEPAGE ► 偏旁
入字旁	rùzìpáng<br>Name of radical number 11 ⼊<br>MEANING <b>enter</b><br>EXAMPLES 內·全·兩·汆<br><br>HOMEPAGE ► 偏旁
⼊	rù<br>Kangxi radical number 11<br>NAME 入字旁 rùzìpáng<br>VARIANTS 入<br>STANDALONE 入<br>MEANING <b>enter</b><br>EXAMPLES 內·全·兩·汆<br>MNEMONIC <i> The open door of a tent</i><br>RANK 44.4%<br>DISTINGHUISH FROM 八,人<br>NOTES <i> modern dictionaries group 人 and 入 together</i><br><br>HOMEPAGE ► 偏旁
丷	bā<br>Variant of radical ⼋ (<b>eight</b>)<br>EXAMPLES 公·六·兮·穴<br><br>HOMEPAGE ► 偏旁
八	bā<br>Variant of radical ⼋ (<b>eight</b>)<br>EXAMPLES 公·六·兮·穴<br><br>HOMEPAGE ► 偏旁
八字旁	bāzìpáng<br>Name of radical number 12 ⼋<br>MEANING <b>eight</b><br>EXAMPLES 公·六·兮·穴<br><br>HOMEPAGE ► 偏旁
⼋	bā<br>Kangxi radical number 12<br>NAME 八字旁 bāzìpáng<br>VARIANTS 丷·八<br>STANDALONE 八<br>MEANING <b>eight</b><br>EXAMPLES 公·六·兮·穴<br>MNEMONIC <i> Indicates separation, to split something. Can also have a meaning like 拔 - to pull out</i><br>RANK 20.1%<br>DISTINGHUISH FROM 入,人<br>NOTES <i> Used in some characters with two downward strokes</i><br><br>HOMEPAGE ► 偏旁
⺆	jiōng<br>Variant of radical ⼌ (<b>wide</b>)<br>EXAMPLES 冇·冊·冉·肉<br><br>HOMEPAGE ► 偏旁
冂	jiōng<br>Variant of radical ⼌ (<b>wide</b>)<br>EXAMPLES 冇·冊·冉·肉<br><br>HOMEPAGE ► 偏旁
同字匡	tóngzìkuāng<br>Name of radical number 13 ⼌<br>MEANING <b>wide</b><br>EXAMPLES 冇·冊·冉·肉<br><br>HOMEPAGE ► 偏旁
⼌	jiōng<br>Kangxi radical number 13<br>NAME 同字匡 tóngzìkuāng<br>VARIANTS ⺆·冂<br>MEANING <b>wide</b><br>EXAMPLES 冇·冊·冉·肉<br>RANK 52.7%<br>NOTES <i> Also known as DOWN BOX radical</i><br><br>HOMEPAGE ► 偏旁
冖	mì<br>Variant of radical ⼍ (<b>cloth cover</b>)<br>EXAMPLES 冗·冠·冥·運<br><br>HOMEPAGE ► 偏旁
秃宝盖	tūbǎogài<br>Name of radical number 14 ⼍<br>MEANING <b>cloth cover</b><br>EXAMPLES 冗·冠·冥·運<br><br>HOMEPAGE ► 偏旁
⼍	mì<br>Kangxi radical number 14<br>NAME 秃宝盖 tūbǎogài<br>VARIANTS 冖<br>MEANING <b>cloth cover</b><br>EXAMPLES 冗·冠·冥·運<br>RANK 59.0%<br>DISTINGHUISH FROM 一·亠·宀·乛<br>NOTES <i> aka COVER radical</i><br><br>HOMEPAGE ► 偏旁
冫	bīng<br>Variant of radical ⼎ (<b>ice</b>)<br>EXAMPLES 冬·冰·冶·凉<br><br>HOMEPAGE ► 偏旁
两点水	liǎngdiǎnshǔi<br>Name of radical number 15 ⼎<br>MEANING <b>ice</b><br>EXAMPLES 冬·冰·冶·凉<br><br>HOMEPAGE ► 偏旁
⼎	bīng<br>Kangxi radical number 15<br>NAME 两点水 liǎngdiǎnshǔi<br>VARIANTS 冫<br>MEANING <b>ice</b><br>EXAMPLES 冬·冰·冶·凉<br>MNEMONIC <i> possibly a reduction of 仌, sometimes indicates a split</i><br>RANK 82.2%<br>DISTINGHUISH FROM 彡，氵<br>NOTES <i> All things cold and icy are encompassed by this radical</i><br><br>HOMEPAGE ► 偏旁
⺇	jī<br>Variant of radical ⼏ (<b>table</b>)<br>EXAMPLES 風·殳·凡·凱<br><br>HOMEPAGE ► 偏旁
几	jī<br>Variant of radical ⼏ (<b>table</b>)<br>EXAMPLES 風·殳·凡·凱<br><br>HOMEPAGE ► 偏旁
𠘧	jī<br>Variant of radical ⼏ (<b>table</b>)<br>EXAMPLES 風·殳·凡·凱<br><br>HOMEPAGE ► 偏旁
𠘨	jī<br>Variant of radical ⼏ (<b>table</b>)<br>EXAMPLES 風·殳·凡·凱<br><br>HOMEPAGE ► 偏旁
几字旁	jīzìpáng<br>Name of radical number 16 ⼏<br>MEANING <b>table</b><br>EXAMPLES 風·殳·凡·凱<br><br>HOMEPAGE ► 偏旁
⼏	jī<br>Kangxi radical number 16<br>NAME 几字旁 jīzìpáng<br>VARIANTS ⺇·几·𠘧·𠘨<br>STANDALONE 几<br>MEANING <b>table</b><br>EXAMPLES 風·殳·凡·凱<br>RANK 63.1%<br><br>HOMEPAGE ► 偏旁
凵	kǎn<br>Variant of radical ⼐ (<b>receptacle</b>)<br>EXAMPLES 凶·凸·凹·齒<br><br>HOMEPAGE ► 偏旁
凶字框	xiōngzìkuàng<br>Name of radical number 17 ⼐<br>MEANING <b>receptacle</b><br>EXAMPLES 凶·凸·凹·齒<br><br>HOMEPAGE ► 偏旁
⼐	kǎn<br>Kangxi radical number 17<br>NAME 凶字框 xiōngzìkuàng<br>VARIANTS 凵<br>MEANING <b>receptacle</b><br>EXAMPLES 凶·凸·凹·齒<br>MNEMONIC <i> primitive of an open vessel or receptacle</i><br>RANK 59.0%<br>NOTES <i> aka open box</i><br><br>HOMEPAGE ► 偏旁
⺈	dāo<br>Variant of radical ⼑ (<b>knife</b>)<br>EXAMPLES 刁·解·分·劍<br><br>HOMEPAGE ► 偏旁
⺉	dāo<br>Variant of radical ⼑ (<b>knife</b>)<br>EXAMPLES 刁·解·分·劍<br><br>HOMEPAGE ► 偏旁
刀	dāo<br>Variant of radical ⼑ (<b>knife</b>)<br>EXAMPLES 刁·解·分·劍<br><br>HOMEPAGE ► 偏旁
刁	dāo<br>Variant of radical ⼑ (<b>knife</b>)<br>EXAMPLES 刁·解·分·劍<br><br>HOMEPAGE ► 偏旁
刂	dāo<br>Variant of radical ⼑ (<b>knife</b>)<br>EXAMPLES 刁·解·分·劍<br><br>HOMEPAGE ► 偏旁
𠂊	dāo<br>Variant of radical ⼑ (<b>knife</b>)<br>EXAMPLES 刁·解·分·劍<br><br>HOMEPAGE ► 偏旁
刀字旁	dāozìpáng<br>Name of radical number 18 ⼑<br>MEANING <b>knife</b><br>EXAMPLES 刁·解·分·劍<br><br>HOMEPAGE ► 偏旁
立刀旁	lìdāopáng<br>Name of radical number 18 ⼑<br>MEANING <b>knife</b><br>EXAMPLES 刁·解·分·劍<br><br>HOMEPAGE ► 偏旁
⼑	dāo<br>Kangxi radical number 18<br>NAME 刀字旁 dāozìpáng·立刀旁 lìdāopáng<br>VARIANTS ⺈·⺉·刀·刁·刂·𠂊<br>STANDALONE 刀<br>MEANING <b>knife</b><br>EXAMPLES 刁·解·分·劍<br>MNEMONIC <i> picture of a ancient bronze knife</i><br>RANK 44.4%<br>DISTINGHUISH FROM 力勹<br>NOTES <i> Encompasses numerous characters relating to sharpness and actions undertaken with sharp items.</i><br><br>HOMEPAGE ► 偏旁
力	lì<br>Variant of radical ⼒ (<b>power</b>)<br>EXAMPLES 加·功·劣·男<br><br>HOMEPAGE ► 偏旁
力字旁	lìzìpáng<br>Name of radical number 19 ⼒<br>MEANING <b>power</b><br>EXAMPLES 加·功·劣·男<br><br>HOMEPAGE ► 偏旁
⼒	lì<br>Kangxi radical number 19<br>NAME 力字旁 lìzìpáng<br>VARIANTS 力<br>STANDALONE 力<br>MEANING <b>power</b><br>EXAMPLES 加·功·劣·男<br>RANK 86.1%<br>DISTINGHUISH FROM 刀<br>NOTES <i> Used in a variety of characters industrious characters, or those having to do with exertion. aka POWER radical</i><br><br>HOMEPAGE ► 偏旁
勹	bāo<br>Variant of radical ⼓ (<b>wrap</b>)<br>EXAMPLES 包·勺·勻·勾<br><br>HOMEPAGE ► 偏旁
包字头	bāozìtóu<br>Name of radical number 20 ⼓<br>MEANING <b>wrap</b><br>EXAMPLES 包·勺·勻·勾<br><br>HOMEPAGE ► 偏旁
⼓	bāo<br>Kangxi radical number 20<br>NAME 包字头 bāozìtóu<br>VARIANTS 勹<br>MEANING <b>wrap</b><br>EXAMPLES 包·勺·勻·勾<br>MNEMONIC <i> A figure leaning over to hold or cover something</i><br>RANK 66.3%<br>DISTINGHUISH FROM 刀,力<br>NOTES <i> Adds a grouping or enclosing meaning to a number of characters, more often as a component as the actual 部首</i><br><br>HOMEPAGE ► 偏旁
匕	bǐ<br>Variant of radical ⼔ (<b>spoon</b>)<br>EXAMPLES 化·北·匙·比<br><br>HOMEPAGE ► 偏旁
匕字旁	bǐzìpáng<br>Name of radical number 21 ⼔<br>MEANING <b>spoon</b><br>EXAMPLES 化·北·匙·比<br><br>HOMEPAGE ► 偏旁
⼔	bǐ<br>Kangxi radical number 21<br>NAME 匕字旁 bǐzìpáng<br>VARIANTS 匕<br>STANDALONE 匕<br>MEANING <b>spoon</b><br>EXAMPLES 化·北·匙·比<br>MNEMONIC <i> picture of a type of spoon or  ladle, possibly an upside down 人 in some characters</i><br>RANK 35.0%<br>NOTES <i> aka spoon</i><br><br>HOMEPAGE ► 偏旁
匚	fāng<br>Variant of radical ⼕ (<b>box</b>)<br>EXAMPLES 匿·區·巨·匠<br><br>HOMEPAGE ► 偏旁
医字框	yìzìkuàng<br>Name of radical number 22 ⼕<br>MEANING <b>box</b><br>EXAMPLES 匿·區·巨·匠<br><br>HOMEPAGE ► 偏旁
⼕	fāng<br>Kangxi radical number 22<br>NAME 医字框 yìzìkuàng<br>VARIANTS 匚<br>STANDALONE 匚<br>MEANING <b>box</b><br>EXAMPLES 匿·區·巨·匠<br>RANK 52.7%<br>DISTINGHUISH FROM 匸<br><br>HOMEPAGE ► 偏旁
匸	xǐ<br>Variant of radical ⼖ (<b>hiding enclosure</b>)<br>EXAMPLES 亡·匹·匼·匽<br><br>HOMEPAGE ► 偏旁
⼖	xǐ<br>Kangxi radical number 23<br>NAME  <br>VARIANTS 匸<br>MEANING <b>hiding enclosure</b><br>EXAMPLES 亡·匹·匼·匽<br>RANK 44.4%<br>DISTINGHUISH FROM 匚<br><br>HOMEPAGE ► 偏旁
十	shí<br>Variant of radical ⼗ (<b>ten</b>)<br>EXAMPLES 千·半·卅·升<br><br>HOMEPAGE ► 偏旁
十字旁	shízìpáng<br>Name of radical number 24 ⼗<br>MEANING <b>ten</b><br>EXAMPLES 千·半·卅·升<br><br>HOMEPAGE ► 偏旁
⼗	shí<br>Kangxi radical number 24<br>NAME 十字旁 shízìpáng<br>VARIANTS 十<br>STANDALONE 十<br>MEANING <b>ten</b><br>EXAMPLES 千·半·卅·升<br>MNEMONIC <i> originally 丨 meaning straight - pronounced zhi - 一 one unit of 丨 pronounced shi</i><br>RANK 78.4%<br><br>HOMEPAGE ► 偏旁
⺊	bǔ<br>Variant of radical ⼘ (<b>divination</b>)<br>EXAMPLES 下·上·卡·占<br><br>HOMEPAGE ► 偏旁
卜	bǔ<br>Variant of radical ⼘ (<b>divination</b>)<br>EXAMPLES 下·上·卡·占<br><br>HOMEPAGE ► 偏旁
⼘	bǔ<br>Kangxi radical number 25<br>NAME  <br>VARIANTS ⺊·卜<br>STANDALONE 卜<br>MEANING <b>divination</b><br>EXAMPLES 下·上·卡·占<br>MNEMONIC <i> represents cracks in a turtle shell which were used for divination</i><br>RANK 59.0%<br><br>HOMEPAGE ► 偏旁
⺋	jié<br>Variant of radical ⼙ (<b>seal (device)</b>)<br>EXAMPLES 即·卬·卷·夗<br><br>HOMEPAGE ► 偏旁
㔾	jié<br>Variant of radical ⼙ (<b>seal (device)</b>)<br>EXAMPLES 即·卬·卷·夗<br><br>HOMEPAGE ► 偏旁
卩	jié<br>Variant of radical ⼙ (<b>seal (device)</b>)<br>EXAMPLES 即·卬·卷·夗<br><br>HOMEPAGE ► 偏旁
单耳刀	dāněrdāo<br>Name of radical number 26 ⼙<br>MEANING <b>seal (device)</b><br>EXAMPLES 即·卬·卷·夗<br><br>HOMEPAGE ► 偏旁
⼙	jié<br>Kangxi radical number 26<br>NAME 单耳刀 dāněrdāo<br>VARIANTS ⺋·㔾·卩<br>MEANING <b>seal (device)</b><br>EXAMPLES 即·卬·卷·夗<br>MNEMONIC <i> A kneeling person - in some cases provides the character meaning as well</i><br>RANK 67.7%<br>NOTES <i> primary form - used on the left side of a character. Most characters don't relate to the characters meaning.</i><br><br>HOMEPAGE ► 偏旁
⺁	chǎng <br>Variant of radical ⼚ (<b>cliff</b>)<br>EXAMPLES 厄·原·厚·厰<br><br>HOMEPAGE ► 偏旁
厂	chǎng <br>Variant of radical ⼚ (<b>cliff</b>)<br>EXAMPLES 厄·原·厚·厰<br><br>HOMEPAGE ► 偏旁
𠂆	chǎng <br>Variant of radical ⼚ (<b>cliff</b>)<br>EXAMPLES 厄·原·厚·厰<br><br>HOMEPAGE ► 偏旁
厂字旁	chǎngzìpáng<br>Name of radical number 27 ⼚<br>MEANING <b>cliff</b><br>EXAMPLES 厄·原·厚·厰<br><br>HOMEPAGE ► 偏旁
⼚	chǎng <br>Kangxi radical number 27<br>NAME 厂字旁 chǎngzìpáng<br>VARIANTS ⺁·厂·𠂆<br>STANDALONE 厂<br>MEANING <b>cliff</b><br>EXAMPLES 厄·原·厚·厰<br>RANK 79.1%<br>DISTINGHUISH FROM 广,疒,⺁<br>NOTES <i> aka SLOPE radical</i><br><br>HOMEPAGE ► 偏旁
厶	sī<br>Variant of radical ⼛ (<b>private</b>)<br>EXAMPLES 台·公·去·參·<br><br>HOMEPAGE ► 偏旁
私字旁	sīzìpáng<br>Name of radical number 28 ⼛<br>MEANING <b>private</b><br>EXAMPLES 台·公·去·參·<br><br>HOMEPAGE ► 偏旁
⼛	sī<br>Kangxi radical number 28<br>NAME 私字旁 sīzìpáng<br>VARIANTS 厶<br>MEANING <b>private</b><br>EXAMPLES 台·公·去·參·<br>MNEMONIC <i> Originally a picture of a tightly wound coccoon.  Some interperetations view it as a mouth whispering</i><br>RANK 59.0%<br>NOTES <i> Used in many characters related to silk</i><br><br>HOMEPAGE ► 偏旁
又	yòu<br>Variant of radical ⼜ (<b>again</b>)<br>EXAMPLES 叉·及·友·取<br><br>HOMEPAGE ► 偏旁
又字旁	yòuzìpáng<br>Name of radical number 29 ⼜<br>MEANING <b>again</b><br>EXAMPLES 叉·及·友·取<br><br>HOMEPAGE ► 偏旁
⼜	yòu<br>Kangxi radical number 29<br>NAME 又字旁 yòuzìpáng<br>VARIANTS 又<br>STANDALONE 又<br>MEANING <b>again</b><br>EXAMPLES 叉·及·友·取<br>MNEMONIC <i> primitive representing the right hand</i><br>RANK 76.3%<br>DISTINGHUISH FROM 攵,文<br>NOTES <i> Like 手, this character also signifies things done by man or with one's hand.  Perhaps because of the higher value placed on the right hand in Chinese culture the meanings here may be of similar value, such as offering friendship (友) or turning against (反).  Modern meaning from sound loan, also called the AGAIN radical</i><br><br>HOMEPAGE ► 偏旁
口	kǒu<br>Variant of radical ⼝ (<b>mouth</b>)<br>EXAMPLES 哎·古·只·品<br><br>HOMEPAGE ► 偏旁
口字旁	kǒuzìpáng<br>Name of radical number 30 ⼝<br>MEANING <b>mouth</b><br>EXAMPLES 哎·古·只·品<br><br>HOMEPAGE ► 偏旁
⼝	kǒu<br>Kangxi radical number 30<br>NAME 口字旁 kǒuzìpáng<br>VARIANTS 口<br>STANDALONE 口<br>MEANING <b>mouth</b><br>EXAMPLES 哎·古·只·品<br>MNEMONIC <i> This is a simple picture of an open mouth</i><br>RANK 99.3%<br>DISTINGHUISH FROM 囗<br>NOTES <i> Used in characters involving things done with one's mouth, eating, speaking, drinking, etc.</i><br><br>HOMEPAGE ► 偏旁
囗	wéi<br>Variant of radical ⼞ (<b>enclosure</b>)<br>EXAMPLES 囚·四·國·圍<br><br>HOMEPAGE ► 偏旁
国字框	guózìkuàng<br>Name of radical number 31 ⼞<br>MEANING <b>enclosure</b><br>EXAMPLES 囚·四·國·圍<br><br>HOMEPAGE ► 偏旁
⼞	wéi<br>Kangxi radical number 31<br>NAME 国字框 guózìkuàng<br>VARIANTS 囗<br>STANDALONE 囗<br>MEANING <b>enclosure</b><br>EXAMPLES 囚·四·國·圍<br>MNEMONIC <i> Represents a wall surrounding something</i><br>RANK 81.2%<br>DISTINGHUISH FROM 口<br>NOTES <i> This radical always surrounds or contains other components, that action generally providing a strong clue to the meaning of the character.  Also known as Surround radical</i><br><br>HOMEPAGE ► 偏旁
土	tǔ<br>Variant of radical ⼟ (<b>earth</b>)<br>EXAMPLES 地·圣·圭·堯<br><br>HOMEPAGE ► 偏旁
提土旁	títǔpáng<br>Name of radical number 32 ⼟<br>MEANING <b>earth</b><br>EXAMPLES 地·圣·圭·堯<br><br>HOMEPAGE ► 偏旁
⼟	tǔ<br>Kangxi radical number 32<br>NAME 提土旁 títǔpáng<br>VARIANTS 土<br>STANDALONE 土<br>MEANING <b>earth</b><br>EXAMPLES 地·圣·圭·堯<br>MNEMONIC <i> a lump of clay on a  potter's wheel or a cross in the earth</i><br>RANK 96.5%<br>DISTINGHUISH FROM 士<br>NOTES <i> Earthly attributes and forces tend to be represented under this radical.  Merged with 士 in many dictionaries</i><br><br>HOMEPAGE ► 偏旁
士	shì<br>Variant of radical ⼠ (<b>scholar</b>)<br>EXAMPLES 壬·喜·時·壽<br><br>HOMEPAGE ► 偏旁
士字旁	shìzìpáng<br>Name of radical number 33 ⼠<br>MEANING <b>scholar</b><br>EXAMPLES 壬·喜·時·壽<br><br>HOMEPAGE ► 偏旁
⼠	shì<br>Kangxi radical number 33<br>NAME 士字旁 shìzìpáng<br>VARIANTS 士<br>STANDALONE 士<br>MEANING <b>scholar</b><br>EXAMPLES 壬·喜·時·壽<br>MNEMONIC <i> The story goes that a scholar (士) took ten (十) things and organized them into one (一); possibly a modification of 大</i><br>RANK 63.1%<br>DISTINGHUISH FROM 土<br>NOTES <i> This radical is used in characters for desirable human attributes or conditions. Merged with 土 in many dictionaries</i><br><br>HOMEPAGE ► 偏旁
夂	zhǐ<br>Variant of radical ⼡ (<b>go</b>)<br>EXAMPLES 各·冬·夆·愛<br><br>HOMEPAGE ► 偏旁
折文旁	zhéwénpáng<br>Name of radical number 34 ⼡<br>MEANING <b>go</b><br>EXAMPLES 各·冬·夆·愛<br><br>HOMEPAGE ► 偏旁
⼡	zhǐ<br>Kangxi radical number 34<br>NAME 折文旁 zhéwénpáng<br>VARIANTS 夂<br>MEANING <b>go</b><br>EXAMPLES 各·冬·夆·愛<br>MNEMONIC <i> A footprint</i><br>RANK 52.7%<br>DISTINGHUISH FROM 夕,夊,歹<br><br>HOMEPAGE ► 偏旁
夊	suī<br>Variant of radical ⼢ (<b>go slowly</b>)<br>EXAMPLES 夌·复·夏<br><br>HOMEPAGE ► 偏旁
⼢	suī<br>Kangxi radical number 35<br>NAME  <br>VARIANTS 夊<br>MEANING <b>go slowly</b><br>EXAMPLES 夌·复·夏<br>MNEMONIC <i> A footprint</i><br>RANK 20.1%<br>DISTINGHUISH FROM 夕,夂,歹<br>NOTES <i> This radical only appears in two common characters - the traditional radical was merged with 夂</i><br><br>HOMEPAGE ► 偏旁
夕	xī<br>Variant of radical ⼣ (<b>evening</b>)<br>EXAMPLES 外·夗·多·岁<br><br>HOMEPAGE ► 偏旁
夕字旁	xīzìpáng<br>Name of radical number 36 ⼣<br>MEANING <b>evening</b><br>EXAMPLES 外·夗·多·岁<br><br>HOMEPAGE ► 偏旁
⼣	xī<br>Kangxi radical number 36<br>NAME 夕字旁 xīzìpáng<br>VARIANTS 夕<br>STANDALONE 夕<br>MEANING <b>evening</b><br>EXAMPLES 外·夗·多·岁<br>MNEMONIC <i> depicts the moon, representing evening</i><br>RANK 44.4%<br>DISTINGHUISH FROM 夂,夊,歹<br>NOTES <i> Subjects such as dreams and night are categorized here</i><br><br>HOMEPAGE ► 偏旁
大	dà<br>Variant of radical ⼤ (<b>big</b>)<br>EXAMPLES 太·天·夭·夯<br><br>HOMEPAGE ► 偏旁
大字旁	dàzìpáng<br>Name of radical number 37 ⼤<br>MEANING <b>big</b><br>EXAMPLES 太·天·夭·夯<br><br>HOMEPAGE ► 偏旁
⼤	dà<br>Kangxi radical number 37<br>NAME 大字旁 dàzìpáng<br>VARIANTS 大<br>STANDALONE 大<br>MEANING <b>big</b><br>EXAMPLES 太·天·夭·夯<br>MNEMONIC <i> A man with arms and legs spread, trying to convey something large</i><br>RANK 88.5%<br><br>HOMEPAGE ► 偏旁
女	nǚ<br>Variant of radical ⼥ (<b>woman</b>)<br>EXAMPLES 妳·婆·奶·如<br><br>HOMEPAGE ► 偏旁
女字旁	nv̌zìpáng<br>Name of radical number 38 ⼥<br>MEANING <b>woman</b><br>EXAMPLES 妳·婆·奶·如<br><br>HOMEPAGE ► 偏旁
⼥	nǚ<br>Kangxi radical number 38<br>NAME 女字旁 nv̌zìpáng<br>VARIANTS 女<br>STANDALONE 女<br>MEANING <b>woman</b><br>EXAMPLES 妳·婆·奶·如<br>MNEMONIC <i> A woman with crossed legs, or possibly breasts</i><br>RANK 95.4%<br>NOTES <i> Generally included in all things feminine, also characters relating to marriage and courtship.</i><br><br>HOMEPAGE ► 偏旁
子	zǐ<br>Variant of radical ⼦ (<b>child</b>)<br>EXAMPLES 孩·學·孔·仔<br><br>HOMEPAGE ► 偏旁
子字旁	zǐzìpáng<br>Name of radical number 39 ⼦<br>MEANING <b>child</b><br>EXAMPLES 孩·學·孔·仔<br><br>HOMEPAGE ► 偏旁
⼦	zǐ<br>Kangxi radical number 39<br>NAME 子字旁 zǐzìpáng<br>VARIANTS 子<br>STANDALONE 子<br>MEANING <b>child</b><br>EXAMPLES 孩·學·孔·仔<br>MNEMONIC <i> A baby with arms & head</i><br>RANK 82.2%<br>NOTES <i> Generally appears in characters relating to life and a child's role in the family</i><br><br>HOMEPAGE ► 偏旁
宀	mián<br>Variant of radical ⼧ (<b>roof</b>)<br>EXAMPLES 家·安·寧·它<br><br>HOMEPAGE ► 偏旁
宝盖头	bǎogàitóu<br>Name of radical number 40 ⼧<br>MEANING <b>roof</b><br>EXAMPLES 家·安·寧·它<br><br>HOMEPAGE ► 偏旁
⼧	mián<br>Kangxi radical number 40<br>NAME 宝盖头 bǎogàitóu<br>VARIANTS 宀<br>MEANING <b>roof</b><br>EXAMPLES 家·安·寧·它<br>MNEMONIC <i> The dot on top may represent a chimney, the edges eaves.</i><br>RANK 93.4%<br>DISTINGHUISH FROM 一·亠·冖·乛<br>NOTES <i> The roof radical can represent various things relating to hearth and home.</i><br><br>HOMEPAGE ► 偏旁
寸	cùn<br>Variant of radical ⼨ (<b>inch</b>)<br>EXAMPLES 村·寺·封·射<br><br>HOMEPAGE ► 偏旁
寸字旁	cùnzìpáng<br>Name of radical number 41 ⼨<br>MEANING <b>inch</b><br>EXAMPLES 村·寺·封·射<br><br>HOMEPAGE ► 偏旁
⼨	cùn<br>Kangxi radical number 41<br>NAME 寸字旁 cùnzìpáng<br>VARIANTS 寸<br>STANDALONE 寸<br>MEANING <b>inch</b><br>EXAMPLES 村·寺·封·射<br>MNEMONIC <i> A hand with finger and thumb measuring something, though the dot could be the thumb itself</i><br>RANK 72.5%<br>NOTES <i> Often used in characters having to do with investigation or measurement of things, also attentiveness and direction</i><br><br>HOMEPAGE ► 偏旁
⺌	xiǎo<br>Variant of radical ⼩ (<b>small</b>)<br>EXAMPLES 少·尖·當·栄<br><br>HOMEPAGE ► 偏旁
⺍	xiǎo<br>Variant of radical ⼩ (<b>small</b>)<br>EXAMPLES 少·尖·當·栄<br><br>HOMEPAGE ► 偏旁
小	xiǎo<br>Variant of radical ⼩ (<b>small</b>)<br>EXAMPLES 少·尖·當·栄<br><br>HOMEPAGE ► 偏旁
𭕄	xiǎo<br>Variant of radical ⼩ (<b>small</b>)<br>EXAMPLES 少·尖·當·栄<br><br>HOMEPAGE ► 偏旁
当字头	dāngzìtóu<br>Name of radical number 42 ⼩<br>MEANING <b>small</b><br>EXAMPLES 少·尖·當·栄<br><br>HOMEPAGE ► 偏旁
⼩	xiǎo<br>Kangxi radical number 42<br>NAME 当字头 dāngzìtóu<br>VARIANTS ⺌·⺍·小·𭕄<br>STANDALONE 小<br>MEANING <b>small</b><br>EXAMPLES 少·尖·當·栄<br>MNEMONIC <i> split 八 and make it small</i><br>RANK 63.1%<br><br>HOMEPAGE ► 偏旁
⺎	wāng<br>Variant of radical ⼪ (<b>lame</b>)<br>EXAMPLES 尤·尷·尬·尩<br><br>HOMEPAGE ► 偏旁
⺏	wāng<br>Variant of radical ⼪ (<b>lame</b>)<br>EXAMPLES 尤·尷·尬·尩<br><br>HOMEPAGE ► 偏旁
⺐	wāng<br>Variant of radical ⼪ (<b>lame</b>)<br>EXAMPLES 尤·尷·尬·尩<br><br>HOMEPAGE ► 偏旁
⺑	wāng<br>Variant of radical ⼪ (<b>lame</b>)<br>EXAMPLES 尤·尷·尬·尩<br><br>HOMEPAGE ► 偏旁
兀	wāng<br>Variant of radical ⼪ (<b>lame</b>)<br>EXAMPLES 尤·尷·尬·尩<br><br>HOMEPAGE ► 偏旁
尢	wāng<br>Variant of radical ⼪ (<b>lame</b>)<br>EXAMPLES 尤·尷·尬·尩<br><br>HOMEPAGE ► 偏旁
尣	wāng<br>Variant of radical ⼪ (<b>lame</b>)<br>EXAMPLES 尤·尷·尬·尩<br><br>HOMEPAGE ► 偏旁
𡯁	wāng<br>Variant of radical ⼪ (<b>lame</b>)<br>EXAMPLES 尤·尷·尬·尩<br><br>HOMEPAGE ► 偏旁
𡯂	wāng<br>Variant of radical ⼪ (<b>lame</b>)<br>EXAMPLES 尤·尷·尬·尩<br><br>HOMEPAGE ► 偏旁
⼪	wāng<br>Kangxi radical number 43<br>NAME  <br>VARIANTS ⺎·⺏·⺐·⺑·兀·尢·尣·𡯁·𡯂<br>STANDALONE 兀<br>MEANING <b>lame</b><br>EXAMPLES 尤·尷·尬·尩<br>MNEMONIC <i> This depicts two legs of different lengths to represent lameness.  The horizontal stroke emphasizes the difference, and may represent arms</i><br>RANK 52.7%<br><br>HOMEPAGE ► 偏旁
尸	shī<br>Variant of radical ⼫ (<b>corpse</b>)<br>EXAMPLES 屍·尺·尼·尻<br><br>HOMEPAGE ► 偏旁
尸字头	shīzìtóu<br>Name of radical number 44 ⼫<br>MEANING <b>corpse</b><br>EXAMPLES 屍·尺·尼·尻<br><br>HOMEPAGE ► 偏旁
⼫	shī<br>Kangxi radical number 44<br>NAME 尸字头 shīzìtóu<br>VARIANTS 尸<br>STANDALONE 尸<br>MEANING <b>corpse</b><br>EXAMPLES 屍·尺·尼·尻<br>MNEMONIC <i> A sitting person facing left (possibly laying)</i><br>RANK 85.0%<br>DISTINGHUISH FROM 戶<br><br>HOMEPAGE ► 偏旁
屮	chè<br>Variant of radical ⼬ (<b>sprout</b>)<br>EXAMPLES 艸·屯·屰·頓<br><br>HOMEPAGE ► 偏旁
⼬	chè<br>Kangxi radical number 45<br>NAME  <br>VARIANTS 屮<br>MEANING <b>sprout</b><br>EXAMPLES 艸·屯·屰·頓<br>MNEMONIC <i> This is a picture of a sprout</i><br>RANK 5.2%<br>NOTES <i> Rare, but worthwhile remembering, as it links to more common words like 出, which is a picture of a 屮 growing out of a 凵</i><br><br>HOMEPAGE ► 偏旁
山	shān<br>Variant of radical ⼭ (<b>mountain</b>)<br>EXAMPLES 嵗·密·峰·幽<br><br>HOMEPAGE ► 偏旁
山字旁	shānzìpáng<br>Name of radical number 46 ⼭<br>MEANING <b>mountain</b><br>EXAMPLES 嵗·密·峰·幽<br><br>HOMEPAGE ► 偏旁
⼭	shān<br>Kangxi radical number 46<br>NAME 山字旁 shānzìpáng<br>VARIANTS 山<br>STANDALONE 山<br>MEANING <b>mountain</b><br>EXAMPLES 嵗·密·峰·幽<br>MNEMONIC <i> Picture of a mountain</i><br>RANK 89.5%<br>NOTES <i> Almost every character under the mountain radical is used for describing landscape features or heights</i><br><br>HOMEPAGE ► 偏旁
巛	chuān<br>Variant of radical ⼮ (<b>river</b>)<br>EXAMPLES 川·州·順·災<br><br>HOMEPAGE ► 偏旁
巜	chuān<br>Variant of radical ⼮ (<b>river</b>)<br>EXAMPLES 川·州·順·災<br><br>HOMEPAGE ► 偏旁
川	chuān<br>Variant of radical ⼮ (<b>river</b>)<br>EXAMPLES 川·州·順·災<br><br>HOMEPAGE ► 偏旁
⼮	chuān<br>Kangxi radical number 47<br>NAME  <br>VARIANTS 巛·巜·川<br>STANDALONE 川<br>MEANING <b>river</b><br>EXAMPLES 川·州·順·災<br>MNEMONIC <i> Picture of moving water</i><br>RANK 20.1%<br><br>HOMEPAGE ► 偏旁
工	gōng<br>Variant of radical ⼯ (<b>work</b>)<br>EXAMPLES 左·巧·功·式<br><br>HOMEPAGE ► 偏旁
工字旁	gōngzìpáng<br>Name of radical number 48 ⼯<br>MEANING <b>work</b><br>EXAMPLES 左·巧·功·式<br><br>HOMEPAGE ► 偏旁
⼯	gōng<br>Kangxi radical number 48<br>NAME 工字旁 gōngzìpáng<br>VARIANTS 工<br>STANDALONE 工<br>MEANING <b>work</b><br>EXAMPLES 左·巧·功·式<br>MNEMONIC <i> Depicts a carpenter's square.</i><br>RANK 59.0%<br><br>HOMEPAGE ► 偏旁
⺒	jǐ<br>Variant of radical ⼰ (<b>oneself</b>)<br>EXAMPLES 記·改·忌·龍<br><br>HOMEPAGE ► 偏旁
己	jǐ<br>Variant of radical ⼰ (<b>oneself</b>)<br>EXAMPLES 記·改·忌·龍<br><br>HOMEPAGE ► 偏旁
已	jǐ<br>Variant of radical ⼰ (<b>oneself</b>)<br>EXAMPLES 記·改·忌·龍<br><br>HOMEPAGE ► 偏旁
巳	jǐ<br>Variant of radical ⼰ (<b>oneself</b>)<br>EXAMPLES 記·改·忌·龍<br><br>HOMEPAGE ► 偏旁
⼰	jǐ<br>Kangxi radical number 49<br>NAME  <br>VARIANTS ⺒·己·已·巳<br>STANDALONE 己<br>MEANING <b>oneself</b><br>EXAMPLES 記·改·忌·龍<br>MNEMONIC <i> represents the back and forth motion of the warp string in weaving</i><br>RANK 44.4%<br><br>HOMEPAGE ► 偏旁
巾	jīn<br>Variant of radical ⼱ (<b>turban</b>)<br>EXAMPLES 市·帥·刷·砸<br><br>HOMEPAGE ► 偏旁
巾字儿	jīnzìér<br>Name of radical number 50 ⼱<br>MEANING <b>turban</b><br>EXAMPLES 市·帥·刷·砸<br><br>HOMEPAGE ► 偏旁
⼱	jīn<br>Kangxi radical number 50<br>NAME 巾字儿 jīnzìér<br>VARIANTS 巾<br>STANDALONE 巾<br>MEANING <b>turban</b><br>EXAMPLES 市·帥·刷·砸<br>MNEMONIC <i> cloth hanging down, possibly from a loom</i><br>RANK 87.8%<br>NOTES <i> The characters under this radical usually represent things made of large expanses of cloth, though smaller items such as headpieces and handkerchiefs are sometimes covered as well.</i><br><br>HOMEPAGE ► 偏旁
干	gān<br>Variant of radical ⼲ (<b>dry</b>)<br>EXAMPLES 旱·开·平·年<br><br>HOMEPAGE ► 偏旁
干字旁	gānzìpáng<br>Name of radical number 51 ⼲<br>MEANING <b>dry</b><br>EXAMPLES 旱·开·平·年<br><br>HOMEPAGE ► 偏旁
⼲	gān<br>Kangxi radical number 51<br>NAME 干字旁 gānzìpáng<br>VARIANTS 干<br>STANDALONE 干<br>MEANING <b>dry</b><br>EXAMPLES 旱·开·平·年<br>MNEMONIC <i> Etymology indicates this is a pestle, but could also be construed as a shield primitive</i><br>RANK 52.7%<br><br>HOMEPAGE ► 偏旁
⺓	yāo<br>Variant of radical ⼳ (<b>short thread</b>)<br>EXAMPLES 幻·麼·幽·幾<br><br>HOMEPAGE ► 偏旁
乡	yāo<br>Variant of radical ⼳ (<b>short thread</b>)<br>EXAMPLES 幻·麼·幽·幾<br><br>HOMEPAGE ► 偏旁
幺	yāo<br>Variant of radical ⼳ (<b>short thread</b>)<br>EXAMPLES 幻·麼·幽·幾<br><br>HOMEPAGE ► 偏旁
⼳	yāo<br>Kangxi radical number 52<br>NAME  <br>VARIANTS ⺓·乡·幺<br>STANDALONE 幺<br>MEANING <b>short thread</b><br>EXAMPLES 幻·麼·幽·幾<br>MNEMONIC <i> evolved from a depiction of coiled silk thread</i><br>RANK 35.0%<br>DISTINGHUISH FROM 糸,·纟<br>NOTES <i> Also known as the SLENDER radical. Seems to relate to that which is seemingly small or slight yet quite the opposite in reality.</i><br><br>HOMEPAGE ► 偏旁
广	guǎng<br>Variant of radical ⼴ (<b>dotted cliff</b>)<br>EXAMPLES 庀·庂·庄<br><br>HOMEPAGE ► 偏旁
广字旁	guǎngzìpáng<br>Name of radical number 53 ⼴<br>MEANING <b>dotted cliff</b><br>EXAMPLES 庀·庂·庄<br><br>HOMEPAGE ► 偏旁
⼴	guǎng<br>Kangxi radical number 53<br>NAME 广字旁 guǎngzìpáng<br>VARIANTS 广<br>STANDALONE 广<br>MEANING <b>dotted cliff</b><br>EXAMPLES 庀·庂·庄<br>MNEMONIC <i> This is a picture of a simple shelter, simplification gave the standalone 部首 a new meaning</i><br>RANK 86.8%<br>NOTES <i> Traditional form with this specific pronunciation/meaning is a different character. Generally in characters relating to different sorts of structures</i><br><br>HOMEPAGE ► 偏旁
廴	yǐn<br>Variant of radical ⼵ (<b>long stride</b>)<br>EXAMPLES 廵·廷·延<br><br>HOMEPAGE ► 偏旁
建之旁	jiànzhīpáng<br>Name of radical number 54 ⼵<br>MEANING <b>long stride</b><br>EXAMPLES 廵·廷·延<br><br>HOMEPAGE ► 偏旁
⼵	yǐn<br>Kangxi radical number 54<br>NAME 建之旁 jiànzhīpáng<br>VARIANTS 廴<br>MEANING <b>long stride</b><br>EXAMPLES 廵·廷·延<br>MNEMONIC <i> Depicts a man marching out</i><br>RANK 35.0%<br>DISTINGHUISH FROM 辶,·⻎,·⻍<br>NOTES <i> References only three common modern characters</i><br><br>HOMEPAGE ► 偏旁
廾	gǒng<br>Variant of radical ⼶ (<b>arch</b>)<br>EXAMPLES 廿·弁·弄<br><br>HOMEPAGE ► 偏旁
弄字底	nòngzìdǐ<br>Name of radical number 55 ⼶<br>MEANING <b>arch</b><br>EXAMPLES 廿·弁·弄<br><br>HOMEPAGE ► 偏旁
⼶	gǒng<br>Kangxi radical number 55<br>NAME 弄字底 nòngzìdǐ<br>VARIANTS 廾<br>MEANING <b>arch</b><br>EXAMPLES 廿·弁·弄<br>MNEMONIC <i> Rough drawing of two joined hands</i><br>RANK 52.7%<br><br>HOMEPAGE ► 偏旁
弋	yì<br>Variant of radical ⼷ (<b>shoot</b>)<br>EXAMPLES 弌·弍·弎<br><br>HOMEPAGE ► 偏旁
⼷	yì<br>Kangxi radical number 56<br>NAME  <br>VARIANTS 弋<br>STANDALONE 弋<br>MEANING <b>shoot</b><br>EXAMPLES 弌·弍·弎<br>MNEMONIC <i> Depicts an ancient weapon described as a retrievable arrow with a string attached</i><br>RANK 5.2%<br>NOTES <i> Also known as the dart radical</i><br><br>HOMEPAGE ► 偏旁
弓	gōng<br>Variant of radical ⼸ (<b>bow</b>)<br>EXAMPLES 弔·引·弗<br><br>HOMEPAGE ► 偏旁
弓字旁	gōngzìpáng<br>Name of radical number 57 ⼸<br>MEANING <b>bow</b><br>EXAMPLES 弔·引·弗<br><br>HOMEPAGE ► 偏旁
⼸	gōng<br>Kangxi radical number 57<br>NAME 弓字旁 gōngzìpáng<br>VARIANTS 弓<br>STANDALONE 弓<br>MEANING <b>bow</b><br>EXAMPLES 弔·引·弗<br>MNEMONIC <i> a bow</i><br>RANK 78.4%<br>NOTES <i> As a bow must be stretched to be shot, characters under this radical tend to deal with elasticity and shooting things</i><br><br>HOMEPAGE ► 偏旁
⺔	jì<br>Variant of radical ⼹ (<b>snout</b>)<br>EXAMPLES 彔·彖·彗<br><br>HOMEPAGE ► 偏旁
⺕	jì<br>Variant of radical ⼹ (<b>snout</b>)<br>EXAMPLES 彔·彖·彗<br><br>HOMEPAGE ► 偏旁
彐	jì<br>Variant of radical ⼹ (<b>snout</b>)<br>EXAMPLES 彔·彖·彗<br><br>HOMEPAGE ► 偏旁
彑	jì<br>Variant of radical ⼹ (<b>snout</b>)<br>EXAMPLES 彔·彖·彗<br><br>HOMEPAGE ► 偏旁
⼹	jì<br>Kangxi radical number 58<br>NAME  <br>VARIANTS ⺔·⺕·彐·彑<br>MEANING <b>snout</b><br>EXAMPLES 彔·彖·彗<br>MNEMONIC <i> tusks and nose of a pig</i><br>RANK 44.4%<br>NOTES <i> There is a third alternate form of this radical which doesn't appear to be encoded in unicode</i><br><br>HOMEPAGE ► 偏旁
彡	shān<br>Variant of radical ⼺ (<b>bristle</b>)<br>EXAMPLES 形·彤·彥<br><br>HOMEPAGE ► 偏旁
三撇儿	sānpiěr<br>Name of radical number 59 ⼺<br>MEANING <b>bristle</b><br>EXAMPLES 形·彤·彥<br><br>HOMEPAGE ► 偏旁
⼺	shān<br>Kangxi radical number 59<br>NAME 三撇儿 sānpiěr<br>VARIANTS 彡<br>STANDALONE 彡<br>MEANING <b>bristle</b><br>EXAMPLES 形·彤·彥<br>MNEMONIC <i> Typically represents hair, sometimes rays or three</i><br>RANK 67.7%<br>DISTINGHUISH FROM 氵,·冫<br>NOTES <i> This radical shows up in characters relating to stripes or imagery, and occasionally to hair.  Also referred to as the bristle radical</i><br><br>HOMEPAGE ► 偏旁
彳	chì<br>Variant of radical ⼻ (<b>step</b>)<br>EXAMPLES 㣔·彴·彷<br><br>HOMEPAGE ► 偏旁
双立人	shuānglìrén<br>Name of radical number 60 ⼻<br>MEANING <b>step</b><br>EXAMPLES 㣔·彴·彷<br><br>HOMEPAGE ► 偏旁
⼻	chì<br>Kangxi radical number 60<br>NAME 双立人 shuānglìrén<br>VARIANTS 彳<br>MEANING <b>step</b><br>EXAMPLES 㣔·彴·彷<br>MNEMONIC <i> This is the 亻radical with an extra stroke, likely representing movement.</i><br>RANK 82.2%<br>DISTINGHUISH FROM 亻<br>NOTES <i> Unlike 辶部 which relates to the greater journey, this 部首 focuses on smaller actions and relates the details of the trip</i><br><br>HOMEPAGE ► 偏旁
⺖	xīn<br>Variant of radical ⼼ (<b>heart</b>)<br>EXAMPLES 必·忉·忌<br><br>HOMEPAGE ► 偏旁
⺗	xīn<br>Variant of radical ⼼ (<b>heart</b>)<br>EXAMPLES 必·忉·忌<br><br>HOMEPAGE ► 偏旁
㣺	xīn<br>Variant of radical ⼼ (<b>heart</b>)<br>EXAMPLES 必·忉·忌<br><br>HOMEPAGE ► 偏旁
心	xīn<br>Variant of radical ⼼ (<b>heart</b>)<br>EXAMPLES 必·忉·忌<br><br>HOMEPAGE ► 偏旁
忄	xīn<br>Variant of radical ⼼ (<b>heart</b>)<br>EXAMPLES 必·忉·忌<br><br>HOMEPAGE ► 偏旁
竖心旁	shùxīnpáng<br>Name of radical number 61 ⼼<br>MEANING <b>heart</b><br>EXAMPLES 必·忉·忌<br><br>HOMEPAGE ► 偏旁
⼼	xīn<br>Kangxi radical number 61<br>NAME 竖心旁 shùxīnpáng<br>VARIANTS ⺖·⺗·㣺·心·忄<br>STANDALONE 心<br>MEANING <b>heart</b><br>EXAMPLES 必·忉·忌<br>MNEMONIC <i> heart lung</i><br>RANK 94.0%<br>NOTES <i> Used in characters relating to emotions.</i><br><br>HOMEPAGE ► 偏旁
戈	gē<br>Variant of radical ⼽ (<b>halberd</b>)<br>EXAMPLES 戊·戉·戌<br><br>HOMEPAGE ► 偏旁
戈字旁	gēzìpáng<br>Name of radical number 62 ⼽<br>MEANING <b>halberd</b><br>EXAMPLES 戊·戉·戌<br><br>HOMEPAGE ► 偏旁
⼽	gē<br>Kangxi radical number 62<br>NAME 戈字旁 gēzìpáng<br>VARIANTS 戈<br>STANDALONE 戈<br>MEANING <b>halberd</b><br>EXAMPLES 戊·戉·戌<br>MNEMONIC <i> This is likely a picture of an ancient weapon called a ge1 which can be seen in museums.  Some suggest it could represent any long handled instrument such as a hoe or axe.</i><br>RANK 71.5%<br>NOTES <i> Often lends a military or combative meaning to its characters</i><br><br>HOMEPAGE ► 偏旁
戶	hù<br>Variant of radical ⼾ (<b>door</b>)<br>EXAMPLES 戹·戼·戽<br><br>HOMEPAGE ► 偏旁
户	hù<br>Variant of radical ⼾ (<b>door</b>)<br>EXAMPLES 戹·戼·戽<br><br>HOMEPAGE ► 偏旁
戸	hù<br>Variant of radical ⼾ (<b>door</b>)<br>EXAMPLES 戹·戼·戽<br><br>HOMEPAGE ► 偏旁
户字旁	hùzìpáng<br>Name of radical number 63 ⼾<br>MEANING <b>door</b><br>EXAMPLES 戹·戼·戽<br><br>HOMEPAGE ► 偏旁
⼾	hù<br>Kangxi radical number 63<br>NAME 户字旁 hùzìpáng<br>VARIANTS 戶·户·戸<br>STANDALONE 户<br>MEANING <b>door</b><br>EXAMPLES 戹·戼·戽<br><br>HOMEPAGE ► 偏旁
⺘	shǒu<br>Variant of radical ⼿ (<b>hand</b>)<br>EXAMPLES 才·扎·扐<br><br>HOMEPAGE ► 偏旁
手	shǒu<br>Variant of radical ⼿ (<b>hand</b>)<br>EXAMPLES 才·扎·扐<br><br>HOMEPAGE ► 偏旁
扌	shǒu<br>Variant of radical ⼿ (<b>hand</b>)<br>EXAMPLES 才·扎·扐<br><br>HOMEPAGE ► 偏旁
才	shǒu<br>Variant of radical ⼿ (<b>hand</b>)<br>EXAMPLES 才·扎·扐<br><br>HOMEPAGE ► 偏旁
龵	shǒu<br>Variant of radical ⼿ (<b>hand</b>)<br>EXAMPLES 才·扎·扐<br><br>HOMEPAGE ► 偏旁
提手旁	tíshǒupáng<br>Name of radical number 64 ⼿<br>MEANING <b>hand</b><br>EXAMPLES 才·扎·扐<br><br>HOMEPAGE ► 偏旁
看字头	kànzìtóu<br>Name of radical number 64 ⼿<br>MEANING <b>hand</b><br>EXAMPLES 才·扎·扐<br><br>HOMEPAGE ► 偏旁
⼿	shǒu<br>Kangxi radical number 64<br>NAME 提手旁 tíshǒupáng·看字头 kànzìtóu<br>VARIANTS ⺘·手·扌·才·龵<br>STANDALONE 手<br>MEANING <b>hand</b><br>EXAMPLES 才·扎·扐<br>MNEMONIC <i> Represents the palm of the hand, possibly the lines of the palm</i><br>RANK 74.6%<br>DISTINGHUISH FROM 毛<br>NOTES <i> Typically signifies actions executed by one's hand.</i><br><br>HOMEPAGE ► 偏旁
支	zhī<br>Variant of radical ⽀ (<b>branch</b>)<br>EXAMPLES 攰·攱·攲<br><br>HOMEPAGE ► 偏旁
⽀	zhī<br>Kangxi radical number 65<br>NAME  <br>VARIANTS 支<br>STANDALONE 支<br>MEANING <b>branch</b><br>EXAMPLES 攰·攱·攲<br>MNEMONIC <i> Hand 又 holding a branch</i><br>RANK 35.0%<br><br>HOMEPAGE ► 偏旁
⺙	pū<br>Variant of radical ⽁ (<b>rap, tap</b>)<br>EXAMPLES 收·攷·攸<br><br>HOMEPAGE ► 偏旁
攴	pū<br>Variant of radical ⽁ (<b>rap, tap</b>)<br>EXAMPLES 收·攷·攸<br><br>HOMEPAGE ► 偏旁
攵	pū<br>Variant of radical ⽁ (<b>rap, tap</b>)<br>EXAMPLES 收·攷·攸<br><br>HOMEPAGE ► 偏旁
反文旁	fǎnwénpáng<br>Name of radical number 66 ⽁<br>MEANING <b>rap, tap</b><br>EXAMPLES 收·攷·攸<br><br>HOMEPAGE ► 偏旁
旧反文旁	jìufǎnwénpáng<br>Name of radical number 66 ⽁<br>MEANING <b>rap, tap</b><br>EXAMPLES 收·攷·攸<br><br>HOMEPAGE ► 偏旁
⽁	pū<br>Kangxi radical number 66<br>NAME 反文旁 fǎnwénpáng·旧反文旁 jìufǎnwénpáng<br>VARIANTS ⺙·攴·攵<br>STANDALONE 攴<br>MEANING <b>rap, tap</b><br>EXAMPLES 收·攷·攸<br>MNEMONIC <i> primitive of a hand 又 holding a tool 卜</i><br>RANK 20.1%<br>DISTINGHUISH FROM 文<br>NOTES <i> As the hand is engaged in knocking, a number of the characters under this radical relate to actions one may make with their hands</i><br><br>HOMEPAGE ► 偏旁
文	wén<br>Variant of radical ⽂ (<b>script</b>)<br>EXAMPLES 斉·斌·斐<br><br>HOMEPAGE ► 偏旁
⽂	wén<br>Kangxi radical number 67<br>NAME  <br>VARIANTS 文<br>STANDALONE 文<br>MEANING <b>script</b><br>EXAMPLES 斉·斌·斐<br>MNEMONIC <i> a tatto on a chest inside cloths</i><br>RANK 44.4%<br>DISTINGHUISH FROM 攵·又<br><br>HOMEPAGE ► 偏旁
斗	dǒu<br>Variant of radical ⽃ (<b>dipper</b>)<br>EXAMPLES 料·斚·斛<br><br>HOMEPAGE ► 偏旁
⽃	dǒu<br>Kangxi radical number 68<br>NAME  <br>VARIANTS 斗<br>STANDALONE 斗<br>MEANING <b>dipper</b><br>EXAMPLES 料·斚·斛<br>MNEMONIC <i> This is a picture of a dipper, measuring out grains represented by the two dots.</i><br>RANK 52.7%<br>NOTES <i> Stands on it's own as a radical, but traditional variant of this character is 鬥, Radical 191. See dou3</i><br><br>HOMEPAGE ► 偏旁
斤	jīn<br>Variant of radical ⽄ (<b>axe</b>)<br>EXAMPLES 斥·斧·斨<br><br>HOMEPAGE ► 偏旁
斤字旁	jīnzìpáng<br>Name of radical number 69 ⽄<br>MEANING <b>axe</b><br>EXAMPLES 斥·斧·斨<br><br>HOMEPAGE ► 偏旁
⽄	jīn<br>Kangxi radical number 69<br>NAME 斤字旁 jīnzìpáng<br>VARIANTS 斤<br>STANDALONE 斤<br>MEANING <b>axe</b><br>EXAMPLES 斥·斧·斨<br>MNEMONIC <i> an axe over or penetrating into an object (the left-most stroke)</i><br>RANK 63.1%<br>NOTES <i> Characters with this radical relate to breaking or dividing actions/concepts</i><br><br>HOMEPAGE ► 偏旁
方	fāng<br>Variant of radical ⽅ (<b>square</b>)<br>EXAMPLES 㫃·於·㫄<br><br>HOMEPAGE ► 偏旁
方字旁	fāngzìpáng<br>Name of radical number 70 ⽅<br>MEANING <b>square</b><br>EXAMPLES 㫃·於·㫄<br><br>HOMEPAGE ► 偏旁
⽅	fāng<br>Kangxi radical number 70<br>NAME 方字旁 fāngzìpáng<br>VARIANTS 方<br>STANDALONE 方<br>MEANING <b>square</b><br>EXAMPLES 㫃·於·㫄<br>MNEMONIC <i> a man 人 carrying a load 工 which must be balanced </i><br>RANK 35.0%<br>NOTES <i> In a number of 字 relating to flags and banners, otherwise doesn't seem to relate to many character's meaning</i><br><br>HOMEPAGE ► 偏旁
⺛	wú<br>Variant of radical ⽆ (<b>not</b>)<br>EXAMPLES 既·旣·旤<br><br>HOMEPAGE ► 偏旁
无	wú<br>Variant of radical ⽆ (<b>not</b>)<br>EXAMPLES 既·旣·旤<br><br>HOMEPAGE ► 偏旁
旡	wú<br>Variant of radical ⽆ (<b>not</b>)<br>EXAMPLES 既·旣·旤<br><br>HOMEPAGE ► 偏旁
⽆	wú<br>Kangxi radical number 71<br>NAME  <br>VARIANTS ⺛·无·旡<br>STANDALONE 无<br>MEANING <b>not</b><br>EXAMPLES 既·旣·旤<br>RANK 20.1%<br>NOTES <i> This variant was introduced with simplified characters, traditional form represents a dancer</i><br><br>HOMEPAGE ► 偏旁
⺜	rì<br>Variant of radical ⽇ (<b>sun</b>)<br>EXAMPLES 旦·旨·早<br><br>HOMEPAGE ► 偏旁
冃	rì<br>Variant of radical ⽇ (<b>sun</b>)<br>EXAMPLES 旦·旨·早<br><br>HOMEPAGE ► 偏旁
日	rì<br>Variant of radical ⽇ (<b>sun</b>)<br>EXAMPLES 旦·旨·早<br><br>HOMEPAGE ► 偏旁
日字旁	rìzìpáng<br>Name of radical number 72 ⽇<br>MEANING <b>sun</b><br>EXAMPLES 旦·旨·早<br><br>HOMEPAGE ► 偏旁
⽇	rì<br>Kangxi radical number 72<br>NAME 日字旁 rìzìpáng<br>VARIANTS ⺜·冃·日<br>STANDALONE 日<br>MEANING <b>sun</b><br>EXAMPLES 旦·旨·早<br>MNEMONIC <i> primitive of the sun, possibly represents the two halves of a day</i><br>RANK 94.7%<br>DISTINGHUISH FROM 曰,·白,·臼<br>NOTES <i> As the sun is the original source of heat and light as well as time keeping such characters are found to use this radical</i><br><br>HOMEPAGE ► 偏旁
曰	yuē<br>Variant of radical ⽈ (<b>say</b>)<br>EXAMPLES 曲·曳·更<br><br>HOMEPAGE ► 偏旁
⽈	yuē<br>Kangxi radical number 73<br>NAME  <br>VARIANTS 曰<br>STANDALONE 曰<br>MEANING <b>say</b><br>EXAMPLES 曲·曳·更<br>MNEMONIC <i> a mouth with something - words - in it</i><br>RANK 67.7%<br>DISTINGHUISH FROM 日,·白,·臼<br>NOTES <i> Most 字 under this radical have little to do with speaking</i><br><br>HOMEPAGE ► 偏旁
⺝	yuè<br>Variant of radical ⽉ (<b>moon</b>)<br>EXAMPLES 有·朋·服<br><br>HOMEPAGE ► 偏旁
月	yuè<br>Variant of radical ⽉ (<b>moon</b>)<br>EXAMPLES 有·朋·服<br><br>HOMEPAGE ► 偏旁
月字旁	yuèzìpáng<br>Name of radical number 74 ⽉<br>MEANING <b>moon</b><br>EXAMPLES 有·朋·服<br><br>HOMEPAGE ► 偏旁
⽉	yuè<br>Kangxi radical number 74<br>NAME 月字旁 yuèzìpáng<br>VARIANTS ⺝·月<br>STANDALONE 月<br>MEANING <b>moon</b><br>EXAMPLES 有·朋·服<br>MNEMONIC <i> primitive of the crescent moon</i><br>RANK 67.7%<br>NOTES <i> Be careful to distinguish this from the meat radical, which looks identical. Often used in characters associated with friendship or romance</i><br><br>HOMEPAGE ► 偏旁
木	mù<br>Variant of radical ⽊ (<b>tree</b>)<br>EXAMPLES 未·末·本<br><br>HOMEPAGE ► 偏旁
朩	mù<br>Variant of radical ⽊ (<b>tree</b>)<br>EXAMPLES 未·末·本<br><br>HOMEPAGE ► 偏旁
木字旁	mùzìpáng<br>Name of radical number 75 ⽊<br>MEANING <b>tree</b><br>EXAMPLES 未·末·本<br><br>HOMEPAGE ► 偏旁
⽊	mù<br>Kangxi radical number 75<br>NAME 木字旁 mùzìpáng<br>VARIANTS 木·朩<br>STANDALONE 木<br>MEANING <b>tree</b><br>EXAMPLES 未·末·本<br>MNEMONIC <i> Primitive, Something like a banyan tree with branches and above ground roots on the bottom</i><br>RANK 98.9%<br>DISTINGHUISH FROM 禾,·釆,·米<br>NOTES <i> Another very common radical, a large portion of the characters using this radical are items manufactured from wood. Also used for trees and fruits</i><br><br>HOMEPAGE ► 偏旁
欠	qiàn<br>Variant of radical ⽋ (<b>lack</b>)<br>EXAMPLES 次·欣·欥<br><br>HOMEPAGE ► 偏旁
欠字旁	qiànzìpáng<br>Name of radical number 76 ⽋<br>MEANING <b>lack</b><br>EXAMPLES 次·欣·欥<br><br>HOMEPAGE ► 偏旁
⽋	qiàn<br>Kangxi radical number 76<br>NAME 欠字旁 qiànzìpáng<br>VARIANTS 欠<br>STANDALONE 欠<br>MEANING <b>lack</b><br>EXAMPLES 次·欣·欥<br>MNEMONIC <i> a man yawning - think of the upper part as a hand covering the mouth while in the act</i><br>RANK 71.5%<br>NOTES <i> The mouth is involved in yawning, and it's also involved in many other emotional displays and vocal actions, many of which are categorized under this 部首</i><br><br>HOMEPAGE ► 偏旁
止	zhǐ<br>Variant of radical ⽌ (<b>stop</b>)<br>EXAMPLES 正·此·步<br><br>HOMEPAGE ► 偏旁
龰	zhǐ<br>Variant of radical ⽌ (<b>stop</b>)<br>EXAMPLES 正·此·步<br><br>HOMEPAGE ► 偏旁
止字旁	zhǐzìpáng<br>Name of radical number 77 ⽌<br>MEANING <b>stop</b><br>EXAMPLES 正·此·步<br><br>HOMEPAGE ► 偏旁
⽌	zhǐ<br>Kangxi radical number 77<br>NAME 止字旁 zhǐzìpáng<br>VARIANTS 止·龰<br>STANDALONE 止<br>MEANING <b>stop</b><br>EXAMPLES 正·此·步<br>MNEMONIC <i> This is a primitive of a foot</i><br>RANK 63.1%<br><br>HOMEPAGE ► 偏旁
⺞	dǎi<br>Variant of radical ⽍ (<b>death</b>)<br>EXAMPLES 歺·死·歿<br><br>HOMEPAGE ► 偏旁
歹	dǎi<br>Variant of radical ⽍ (<b>death</b>)<br>EXAMPLES 歺·死·歿<br><br>HOMEPAGE ► 偏旁
歺	dǎi<br>Variant of radical ⽍ (<b>death</b>)<br>EXAMPLES 歺·死·歿<br><br>HOMEPAGE ► 偏旁
⽍	dǎi<br>Kangxi radical number 78<br>NAME  <br>VARIANTS ⺞·歹·歺<br>STANDALONE 歹<br>MEANING <b>death</b><br>EXAMPLES 歺·死·歿<br>MNEMONIC <i> A chip or remnant of a scapula bone 骨</i><br>RANK 67.7%<br><br>HOMEPAGE ► 偏旁
殳	shū<br>Variant of radical ⽎ (<b>weapon</b>)<br>EXAMPLES 段·殷·殺<br><br>HOMEPAGE ► 偏旁
殳字旁	shūzìpáng<br>Name of radical number 79 ⽎<br>MEANING <b>weapon</b><br>EXAMPLES 段·殷·殺<br><br>HOMEPAGE ► 偏旁
⽎	shū<br>Kangxi radical number 79<br>NAME 殳字旁 shūzìpáng<br>VARIANTS 殳<br>STANDALONE 殳<br>MEANING <b>weapon</b><br>EXAMPLES 段·殷·殺<br>MNEMONIC <i> A hand 又 holding a weapon, probably a club</i><br>RANK 59.0%<br>NOTES <i> Also known as the KILL radical.  A number of actions of violence are categorized under this 部首. In context usually means -ing</i><br><br>HOMEPAGE ► 偏旁
⺟	wú<br>Variant of radical ⽏ (<b>do not</b>)<br>EXAMPLES 母·每·毐<br><br>HOMEPAGE ► 偏旁
毋	wú<br>Variant of radical ⽏ (<b>do not</b>)<br>EXAMPLES 母·每·毐<br><br>HOMEPAGE ► 偏旁
毌	wú<br>Variant of radical ⽏ (<b>do not</b>)<br>EXAMPLES 母·每·毐<br><br>HOMEPAGE ► 偏旁
母	wú<br>Variant of radical ⽏ (<b>do not</b>)<br>EXAMPLES 母·每·毐<br><br>HOMEPAGE ► 偏旁
⽏	wú<br>Kangxi radical number 80<br>NAME  <br>VARIANTS ⺟·毋·毌·母<br>STANDALONE 毋<br>MEANING <b>do not</b><br>EXAMPLES 母·每·毐<br>MNEMONIC <i> a woman with bound breasts - untouchable</i><br>RANK 35.0%<br>NOTES <i> Removed from modern simplified radical tables</i><br><br>HOMEPAGE ► 偏旁
比	bǐ<br>Variant of radical ⽐ (<b>compare</b>)<br>EXAMPLES 毖·毗·毘<br><br>HOMEPAGE ► 偏旁
⽐	bǐ<br>Kangxi radical number 81<br>NAME  <br>VARIANTS 比<br>STANDALONE 比<br>MEANING <b>compare</b><br>EXAMPLES 毖·毗·毘<br>MNEMONIC <i> Two people or objects side by side for comparison</i><br>RANK 52.7%<br><br>HOMEPAGE ► 偏旁
毛	máo<br>Variant of radical ⽑ (<b>fur</b>)<br>EXAMPLES 毡·毣·毧<br><br>HOMEPAGE ► 偏旁
⽑	máo<br>Kangxi radical number 82<br>NAME  <br>VARIANTS 毛<br>STANDALONE 毛<br>MEANING <b>fur</b><br>EXAMPLES 毡·毣·毧<br>MNEMONIC <i> a feather</i><br>RANK 44.4%<br>DISTINGHUISH FROM 手<br>NOTES <i> This radical relates to fur and feathers as garments, and by extension most types of garments</i><br><br>HOMEPAGE ► 偏旁
⺠	shì<br>Variant of radical ⽒ (<b>clan</b>)<br>EXAMPLES 氐·民·氓<br><br>HOMEPAGE ► 偏旁
氏	shì<br>Variant of radical ⽒ (<b>clan</b>)<br>EXAMPLES 氐·民·氓<br><br>HOMEPAGE ► 偏旁
民	shì<br>Variant of radical ⽒ (<b>clan</b>)<br>EXAMPLES 氐·民·氓<br><br>HOMEPAGE ► 偏旁
⽒	shì<br>Kangxi radical number 83<br>NAME  <br>VARIANTS ⺠·氏·民<br>STANDALONE 氏<br>MEANING <b>clan</b><br>EXAMPLES 氐·民·氓<br>MNEMONIC <i> a man bowing</i><br>RANK 20.1%<br><br>HOMEPAGE ► 偏旁
气	qì<br>Variant of radical ⽓ (<b>steam</b>)<br>EXAMPLES 氕·氘·氚<br><br>HOMEPAGE ► 偏旁
⽓	qì<br>Kangxi radical number 84<br>NAME  <br>VARIANTS 气<br>STANDALONE 气<br>MEANING <b>steam</b><br>EXAMPLES 氕·氘·氚<br>MNEMONIC <i> a man blowing air from his mouth</i><br>RANK 72.5%<br><br>HOMEPAGE ► 偏旁
⺡	shuǐ<br>Variant of radical ⽔ (<b>water</b>)<br>EXAMPLES 永·氷·氾<br><br>HOMEPAGE ► 偏旁
⺢	shuǐ<br>Variant of radical ⽔ (<b>water</b>)<br>EXAMPLES 永·氷·氾<br><br>HOMEPAGE ► 偏旁
水	shuǐ<br>Variant of radical ⽔ (<b>water</b>)<br>EXAMPLES 永·氷·氾<br><br>HOMEPAGE ► 偏旁
氵	shuǐ<br>Variant of radical ⽔ (<b>water</b>)<br>EXAMPLES 永·氷·氾<br><br>HOMEPAGE ► 偏旁
氺	shuǐ<br>Variant of radical ⽔ (<b>water</b>)<br>EXAMPLES 永·氷·氾<br><br>HOMEPAGE ► 偏旁
三点水	sāndiǎnshǔi<br>Name of radical number 85 ⽔<br>MEANING <b>water</b><br>EXAMPLES 永·氷·氾<br><br>HOMEPAGE ► 偏旁
⽔	shuǐ<br>Kangxi radical number 85<br>NAME 三点水 sāndiǎnshǔi<br>VARIANTS ⺡·⺢·水·氵·氺<br>STANDALONE 水<br>MEANING <b>water</b><br>EXAMPLES 永·氷·氾<br>MNEMONIC <i> A drawing of waves</i><br>RANK 52.7%<br>NOTES <i> The standalone version of the radical typically is not used as a character component, see 氵</i><br><br>HOMEPAGE ► 偏旁
⺣	huǒ<br>Variant of radical ⽕ (<b>fire</b>)<br>EXAMPLES 灰·灯·灶<br><br>HOMEPAGE ► 偏旁
火	huǒ<br>Variant of radical ⽕ (<b>fire</b>)<br>EXAMPLES 灰·灯·灶<br><br>HOMEPAGE ► 偏旁
灬	huǒ<br>Variant of radical ⽕ (<b>fire</b>)<br>EXAMPLES 灰·灯·灶<br><br>HOMEPAGE ► 偏旁
四点底	sìdiǎndǐ<br>Name of radical number 86 ⽕<br>MEANING <b>fire</b><br>EXAMPLES 灰·灯·灶<br><br>HOMEPAGE ► 偏旁
火字旁	huǒzìpáng<br>Name of radical number 86 ⽕<br>MEANING <b>fire</b><br>EXAMPLES 灰·灯·灶<br><br>HOMEPAGE ► 偏旁
⽕	huǒ<br>Kangxi radical number 86<br>NAME 四点底 sìdiǎndǐ·火字旁 huǒzìpáng<br>VARIANTS ⺣·火·灬<br>STANDALONE 火<br>MEANING <b>fire</b><br>EXAMPLES 灰·灯·灶<br>MNEMONIC <i> drawing of fire</i><br>RANK 95.1%<br>NOTES <i> Represents characters having to do with fire, heat, and cooking</i><br><br>HOMEPAGE ► 偏旁
⺤	zhǎo<br>Variant of radical ⽖ (<b>claw</b>)<br>EXAMPLES 爬·爭·爰<br><br>HOMEPAGE ► 偏旁
⺥	zhǎo<br>Variant of radical ⽖ (<b>claw</b>)<br>EXAMPLES 爬·爭·爰<br><br>HOMEPAGE ► 偏旁
爪	zhǎo<br>Variant of radical ⽖ (<b>claw</b>)<br>EXAMPLES 爬·爭·爰<br><br>HOMEPAGE ► 偏旁
爫	zhǎo<br>Variant of radical ⽖ (<b>claw</b>)<br>EXAMPLES 爬·爭·爰<br><br>HOMEPAGE ► 偏旁
受字头	shòuzìtóu<br>Name of radical number 87 ⽖<br>MEANING <b>claw</b><br>EXAMPLES 爬·爭·爰<br><br>HOMEPAGE ► 偏旁
⽖	zhǎo<br>Kangxi radical number 87<br>NAME 受字头 shòuzìtóu<br>VARIANTS ⺤·⺥·爪·爫<br>STANDALONE 爪<br>MEANING <b>claw</b><br>EXAMPLES 爬·爭·爰<br>MNEMONIC <i> Hand or claw 爫爪 grabbing something from above</i><br>RANK 20.1%<br><br>HOMEPAGE ► 偏旁
父	fù<br>Variant of radical ⽗ (<b>father</b>)<br>EXAMPLES 爸·爹·爺<br><br>HOMEPAGE ► 偏旁
⽗	fù<br>Kangxi radical number 88<br>NAME  <br>VARIANTS 父<br>STANDALONE 父<br>MEANING <b>father</b><br>EXAMPLES 爸·爹·爺<br>MNEMONIC <i> Hand, sound borrowed from 斧</i><br>RANK 44.4%<br><br>HOMEPAGE ► 偏旁
爻	yáo<br>Variant of radical ⽘ (<b>Trigrams</b>)<br>EXAMPLES 爼·爽·爾<br><br>HOMEPAGE ► 偏旁
⽘	yáo<br>Kangxi radical number 89<br>NAME  <br>VARIANTS 爻<br>STANDALONE 爻<br>MEANING <b>Trigrams</b><br>EXAMPLES 爼·爽·爾<br>MNEMONIC <i> Indicates strokes, marked or cut</i><br>RANK 20.1%<br><br>HOMEPAGE ► 偏旁
⺦	qiáng<br>Variant of radical ⽙ (<b>split wood</b>)<br>EXAMPLES 牀·牁·牂<br><br>HOMEPAGE ► 偏旁
丬	qiáng<br>Variant of radical ⽙ (<b>split wood</b>)<br>EXAMPLES 牀·牁·牂<br><br>HOMEPAGE ► 偏旁
爿	qiáng<br>Variant of radical ⽙ (<b>split wood</b>)<br>EXAMPLES 牀·牁·牂<br><br>HOMEPAGE ► 偏旁
将字旁	jiāngzìpáng<br>Name of radical number 90 ⽙<br>MEANING <b>split wood</b><br>EXAMPLES 牀·牁·牂<br><br>HOMEPAGE ► 偏旁
⽙	qiáng<br>Kangxi radical number 90<br>NAME 将字旁 jiāngzìpáng<br>VARIANTS ⺦·丬·爿<br>MEANING <b>split wood</b><br>EXAMPLES 牀·牁·牂<br>MNEMONIC <i> right hand table/board</i><br>RANK 5.2%<br>DISTINGHUISH FROM 片<br><br>HOMEPAGE ► 偏旁
片	piàn<br>Variant of radical ⽚ (<b>slice</b>)<br>EXAMPLES 版·牉·牌<br><br>HOMEPAGE ► 偏旁
⽚	piàn<br>Kangxi radical number 91<br>NAME  <br>VARIANTS 片<br>STANDALONE 片<br>MEANING <b>slice</b><br>EXAMPLES 版·牉·牌<br>MNEMONIC <i> A table with legs (possibly a bed), i.e. the reverse of 爿, which also represents a table. A place where documents are created.</i><br>RANK 35.0%<br>DISTINGHUISH FROM 爿<br>NOTES <i> This radical is primarily used for representing various types of documents</i><br><br>HOMEPAGE ► 偏旁
牙	yá<br>Variant of radical ⽛ (<b>fang</b>)<br>EXAMPLES 㸦·㸧·牚<br><br>HOMEPAGE ► 偏旁
⽛	yá<br>Kangxi radical number 92<br>NAME  <br>VARIANTS 牙<br>STANDALONE 牙<br>MEANING <b>fang</b><br>EXAMPLES 㸦·㸧·牚<br>MNEMONIC <i> This is a picture of teeth</i><br>RANK 5.2%<br>NOTES <i> Usually loans it's sound to other characters</i><br><br>HOMEPAGE ► 偏旁
⺧	niú<br>Variant of radical ⽜ (<b>cow</b>)<br>EXAMPLES 牝·牟·牠<br><br>HOMEPAGE ► 偏旁
牛	niú<br>Variant of radical ⽜ (<b>cow</b>)<br>EXAMPLES 牝·牟·牠<br><br>HOMEPAGE ► 偏旁
牜	niú<br>Variant of radical ⽜ (<b>cow</b>)<br>EXAMPLES 牝·牟·牠<br><br>HOMEPAGE ► 偏旁
𠂒	niú<br>Variant of radical ⽜ (<b>cow</b>)<br>EXAMPLES 牝·牟·牠<br><br>HOMEPAGE ► 偏旁
牛字旁	níuzìpáng<br>Name of radical number 93 ⽜<br>MEANING <b>cow</b><br>EXAMPLES 牝·牟·牠<br><br>HOMEPAGE ► 偏旁
⽜	niú<br>Kangxi radical number 93<br>NAME 牛字旁 níuzìpáng<br>VARIANTS ⺧·牛·牜·𠂒<br>STANDALONE 牛<br>MEANING <b>cow</b><br>EXAMPLES 牝·牟·牠<br>MNEMONIC <i> A cow with horns and ears</i><br>RANK 59.0%<br><br>HOMEPAGE ► 偏旁
⺨	quǎn<br>Variant of radical ⽝ (<b>dog</b>)<br>EXAMPLES 犮·犯·犰<br><br>HOMEPAGE ► 偏旁
犬	quǎn<br>Variant of radical ⽝ (<b>dog</b>)<br>EXAMPLES 犮·犯·犰<br><br>HOMEPAGE ► 偏旁
犭	quǎn<br>Variant of radical ⽝ (<b>dog</b>)<br>EXAMPLES 犮·犯·犰<br><br>HOMEPAGE ► 偏旁
反犬旁	fǎnquǎnpáng<br>Name of radical number 94 ⽝<br>MEANING <b>dog</b><br>EXAMPLES 犮·犯·犰<br><br>HOMEPAGE ► 偏旁
⽝	quǎn<br>Kangxi radical number 94<br>NAME 反犬旁 fǎnquǎnpáng<br>VARIANTS ⺨·犬·犭<br>STANDALONE 犬<br>MEANING <b>dog</b><br>EXAMPLES 犮·犯·犰<br>MNEMONIC <i> This is a picture of a dog - rotate in the same direction as other animal radicals such as 龜 and the similarity becomes clearer</i><br>RANK 20.1%<br>DISTINGHUISH FROM 大太<br>NOTES <i> The dog radical is often used for medium sized animals and dog-like personality traits, leaning towards the fiercer traits</i><br><br>HOMEPAGE ► 偏旁
玄	xuán<br>Variant of radical ⽞ (<b>profound</b>)<br>EXAMPLES 玅·率·玈<br><br>HOMEPAGE ► 偏旁
⽞	xuán<br>Kangxi radical number 95<br>NAME  <br>VARIANTS 玄<br>STANDALONE 玄<br>MEANING <b>profound</b><br>EXAMPLES 玅·率·玈<br>MNEMONIC <i> a piece of yarn 糸 being dyed black</i><br>RANK 20.1%<br>DISTINGHUISH FROM 幺,纟<br><br>HOMEPAGE ► 偏旁
⺩	yù<br>Variant of radical ⽟ (<b>jade</b>)<br>EXAMPLES 玻·瑪·璧<br><br>HOMEPAGE ► 偏旁
玉	yù<br>Variant of radical ⽟ (<b>jade</b>)<br>EXAMPLES 玻·瑪·璧<br><br>HOMEPAGE ► 偏旁
玊	yù<br>Variant of radical ⽟ (<b>jade</b>)<br>EXAMPLES 玻·瑪·璧<br><br>HOMEPAGE ► 偏旁
王	yù<br>Variant of radical ⽟ (<b>jade</b>)<br>EXAMPLES 玻·瑪·璧<br><br>HOMEPAGE ► 偏旁
𤣩	yù<br>Variant of radical ⽟ (<b>jade</b>)<br>EXAMPLES 玻·瑪·璧<br><br>HOMEPAGE ► 偏旁
王字旁	wángzìpáng<br>Name of radical number 96 ⽟<br>MEANING <b>jade</b><br>EXAMPLES 玻·瑪·璧<br><br>HOMEPAGE ► 偏旁
⽟	yù<br>Kangxi radical number 96<br>NAME 王字旁 wángzìpáng<br>VARIANTS ⺩·玉·玊·王·𤣩<br>STANDALONE 玉<br>MEANING <b>jade</b><br>EXAMPLES 玻·瑪·璧<br>MNEMONIC <i> Originally represented jade disks on a string.</i><br>RANK 20.1%<br>NOTES <i> This variant is infrequently used.  Typically found in characters having to do with precious/valuable things, stones in particular</i><br><br>HOMEPAGE ► 偏旁
瓜	guā<br>Variant of radical ⽠ (<b>melon</b>)<br>EXAMPLES 瓝·瓞·瓟<br><br>HOMEPAGE ► 偏旁
⽠	guā<br>Kangxi radical number 97<br>NAME  <br>VARIANTS 瓜<br>STANDALONE 瓜<br>MEANING <b>melon</b><br>EXAMPLES 瓝·瓞·瓟<br>MNEMONIC <i> A sprawling plant, the gourd is the hook at the bottom</i><br>RANK 44.4%<br><br>HOMEPAGE ► 偏旁
瓦	wǎ<br>Variant of radical ⽡ (<b>tile</b>)<br>EXAMPLES 㼚·瓮·瓫<br><br>HOMEPAGE ► 偏旁
⽡	wǎ<br>Kangxi radical number 98<br>NAME  <br>VARIANTS 瓦<br>STANDALONE 瓦<br>MEANING <b>tile</b><br>EXAMPLES 㼚·瓮·瓫<br>MNEMONIC <i> A curved interlocking roof tile</i><br>RANK 52.7%<br>NOTES <i> The few characters under this radical were all originally earthenware items.</i><br><br>HOMEPAGE ► 偏旁
甘	gān<br>Variant of radical ⽢ (<b>sweet</b>)<br>EXAMPLES 甚·甜·甛<br><br>HOMEPAGE ► 偏旁
⽢	gān<br>Kangxi radical number 99<br>NAME  <br>VARIANTS 甘<br>STANDALONE 甘<br>MEANING <b>sweet</b><br>EXAMPLES 甚·甜·甛<br>MNEMONIC <i> something sweet in the mouth 口</i><br>RANK 35.0%<br><br>HOMEPAGE ► 偏旁
生	shēng<br>Variant of radical ⽣ (<b>life</b>)<br>EXAMPLES 甡·產·甥<br><br>HOMEPAGE ► 偏旁
⽣	shēng<br>Kangxi radical number 100<br>NAME  <br>VARIANTS 生<br>STANDALONE 生<br>MEANING <b>life</b><br>EXAMPLES 甡·產·甥<br>MNEMONIC <i> a plant 屮 sprouting from the ground 土</i><br>RANK 20.1%<br><br>HOMEPAGE ► 偏旁
用	yòng<br>Variant of radical ⽤ (<b>use</b>)<br>EXAMPLES 甩·甫·甬<br><br>HOMEPAGE ► 偏旁
甩	yòng<br>Variant of radical ⽤ (<b>use</b>)<br>EXAMPLES 甩·甫·甬<br><br>HOMEPAGE ► 偏旁
⽤	yòng<br>Kangxi radical number 101<br>NAME  <br>VARIANTS 用·甩<br>STANDALONE 用<br>MEANING <b>use</b><br>EXAMPLES 甩·甫·甬<br>MNEMONIC <i> Likely represents a container</i><br>RANK 35.0%<br><br>HOMEPAGE ► 偏旁
田	tián<br>Variant of radical ⽥ (<b>field</b>)<br>EXAMPLES 由·甲·申<br><br>HOMEPAGE ► 偏旁
由	tián<br>Variant of radical ⽥ (<b>field</b>)<br>EXAMPLES 由·甲·申<br><br>HOMEPAGE ► 偏旁
甲	tián<br>Variant of radical ⽥ (<b>field</b>)<br>EXAMPLES 由·甲·申<br><br>HOMEPAGE ► 偏旁
申	tián<br>Variant of radical ⽥ (<b>field</b>)<br>EXAMPLES 由·甲·申<br><br>HOMEPAGE ► 偏旁
电	tián<br>Variant of radical ⽥ (<b>field</b>)<br>EXAMPLES 由·甲·申<br><br>HOMEPAGE ► 偏旁
田字旁	tiánzìpáng<br>Name of radical number 102 ⽥<br>MEANING <b>field</b><br>EXAMPLES 由·甲·申<br><br>HOMEPAGE ► 偏旁
⽥	tián<br>Kangxi radical number 102<br>NAME 田字旁 tiánzìpáng<br>VARIANTS 田·由·甲·申·电<br>STANDALONE 田<br>MEANING <b>field</b><br>EXAMPLES 由·甲·申<br>MNEMONIC <i> represents a rice paddy</i><br>RANK 76.3%<br><br>HOMEPAGE ► 偏旁
⺪	pǐ<br>Variant of radical ⽦ (<b>bolt of cloth</b>)<br>EXAMPLES 疌·疏·疎<br><br>HOMEPAGE ► 偏旁
疋	pǐ<br>Variant of radical ⽦ (<b>bolt of cloth</b>)<br>EXAMPLES 疌·疏·疎<br><br>HOMEPAGE ► 偏旁
𤴔	pǐ<br>Variant of radical ⽦ (<b>bolt of cloth</b>)<br>EXAMPLES 疌·疏·疎<br><br>HOMEPAGE ► 偏旁
疋字底	pǐzìdǐ<br>Name of radical number 103 ⽦<br>MEANING <b>bolt of cloth</b><br>EXAMPLES 疌·疏·疎<br><br>HOMEPAGE ► 偏旁
⽦	pǐ<br>Kangxi radical number 103<br>NAME 疋字底 pǐzìdǐ<br>VARIANTS ⺪·疋·𤴔<br>STANDALONE 疋<br>MEANING <b>bolt of cloth</b><br>EXAMPLES 疌·疏·疎<br>RANK 5.2%<br>NOTES <i> generally superseded by 匹</i><br><br>HOMEPAGE ► 偏旁
疒	nè<br>Variant of radical ⽧ (<b>sickness</b>)<br>EXAMPLES 疔·疚·疝<br><br>HOMEPAGE ► 偏旁
病字旁	bìngzìpáng<br>Name of radical number 104 ⽧<br>MEANING <b>sickness</b><br>EXAMPLES 疔·疚·疝<br><br>HOMEPAGE ► 偏旁
⽧	nè<br>Kangxi radical number 104<br>NAME 病字旁 bìngzìpáng<br>VARIANTS 疒<br>MEANING <b>sickness</b><br>EXAMPLES 疔·疚·疝<br>MNEMONIC <i> A sick person stretched out on a bed (on the left - 丬)</i><br>RANK 92.3%<br>NOTES <i> If the character represents some disease or affliction then odds are good that this is the 部首</i><br><br>HOMEPAGE ► 偏旁
癶	bō<br>Variant of radical ⽨ (<b>footsteps</b>)<br>EXAMPLES 癸·癹·発<br><br>HOMEPAGE ► 偏旁
登字头	dēngzìtóu<br>Name of radical number 105 ⽨<br>MEANING <b>footsteps</b><br>EXAMPLES 癸·癹·発<br><br>HOMEPAGE ► 偏旁
⽨	bō<br>Kangxi radical number 105<br>NAME 登字头 dēngzìtóu<br>VARIANTS 癶<br>MEANING <b>footsteps</b><br>EXAMPLES 癸·癹·発<br>MNEMONIC <i> Two feet - 止 - back-to-back</i><br>RANK 20.1%<br>NOTES <i> This radical only links to three characters in modern usage - 發，噔，and 癸</i><br><br>HOMEPAGE ► 偏旁
白	bái<br>Variant of radical ⽩ (<b>white</b>)<br>EXAMPLES 百·皀·皁<br><br>HOMEPAGE ► 偏旁
白字旁	báizìpáng<br>Name of radical number 106 ⽩<br>MEANING <b>white</b><br>EXAMPLES 百·皀·皁<br><br>HOMEPAGE ► 偏旁
⽩	bái<br>Kangxi radical number 106<br>NAME 白字旁 báizìpáng<br>VARIANTS 白<br>STANDALONE 白<br>MEANING <b>white</b><br>EXAMPLES 百·皀·皁<br>MNEMONIC <i> A modification of the sun - 日 - to represent white</i><br>RANK 67.7%<br>DISTINGHUISH FROM 日,·曰,·臼,·目<br>NOTES <i> Associated with the idea of purity and brightness in many 字</i><br><br>HOMEPAGE ► 偏旁
皮	pí<br>Variant of radical ⽪ (<b>skin</b>)<br>EXAMPLES 皯·皰·皴<br><br>HOMEPAGE ► 偏旁
皮字旁	pízìpáng<br>Name of radical number 107 ⽪<br>MEANING <b>skin</b><br>EXAMPLES 皯·皰·皴<br><br>HOMEPAGE ► 偏旁
⽪	pí<br>Kangxi radical number 107<br>NAME 皮字旁 pízìpáng<br>VARIANTS 皮<br>STANDALONE 皮<br>MEANING <b>skin</b><br>EXAMPLES 皯·皰·皴<br>MNEMONIC <i> A hand 又 flaying an animal hide</i><br>RANK 35.0%<br>NOTES <i> In a number of characters relating to different skin attributes/conditions as well as a number of different articles of clothing which once may have been made from hides</i><br><br>HOMEPAGE ► 偏旁
皿	mǐn<br>Variant of radical ⽫ (<b>dish</b>)<br>EXAMPLES 盂·盃·盅<br><br>HOMEPAGE ► 偏旁
皿字底	mǐnzìdǐ<br>Name of radical number 108 ⽫<br>MEANING <b>dish</b><br>EXAMPLES 盂·盃·盅<br><br>HOMEPAGE ► 偏旁
⽫	mǐn<br>Kangxi radical number 108<br>NAME 皿字底 mǐnzìdǐ<br>VARIANTS 皿<br>STANDALONE 皿<br>MEANING <b>dish</b><br>EXAMPLES 盂·盃·盅<br>MNEMONIC <i> Primitive of a tub or plate</i><br>RANK 79.1%<br>NOTES <i> Numerous types of receptacles and their uses are categorized under this 部首</i><br><br>HOMEPAGE ► 偏旁
目	mù<br>Variant of radical ⽬ (<b>eye</b>)<br>EXAMPLES 盯·盱·盲<br><br>HOMEPAGE ► 偏旁
目字旁	mùzìpáng<br>Name of radical number 109 ⽬<br>MEANING <b>eye</b><br>EXAMPLES 盯·盱·盲<br><br>HOMEPAGE ► 偏旁
⽬	mù<br>Kangxi radical number 109<br>NAME 目字旁 mùzìpáng<br>VARIANTS 目<br>STANDALONE 目<br>MEANING <b>eye</b><br>EXAMPLES 盯·盱·盲<br>MNEMONIC <i> This is a picture of an eye (on its' side)</i><br>RANK 91.6%<br>DISTINGHUISH FROM 日,·曰,·臼<br>NOTES <i> Used in characters which relate to seeing (or not seeing)</i><br><br>HOMEPAGE ► 偏旁
矛	máo<br>Variant of radical ⽭ (<b>spear</b>)<br>EXAMPLES 矜·矞·矟<br><br>HOMEPAGE ► 偏旁
⽭	máo<br>Kangxi radical number 110<br>NAME  <br>VARIANTS 矛<br>STANDALONE 矛<br>MEANING <b>spear</b><br>EXAMPLES 矜·矞·矟<br>MNEMONIC <i> A saw lance made of flint disks</i><br>RANK 5.2%<br><br>HOMEPAGE ► 偏旁
矢	shǐ<br>Variant of radical ⽮ (<b>arrow</b>)<br>EXAMPLES 矣·知·矧<br><br>HOMEPAGE ► 偏旁
⽮	shǐ<br>Kangxi radical number 111<br>NAME  <br>VARIANTS 矢<br>STANDALONE 矢<br>MEANING <b>arrow</b><br>EXAMPLES 矣·知·矧<br>MNEMONIC <i> A picture - the point is at the top, feathers and knock below</i><br>RANK 63.1%<br><br>HOMEPAGE ► 偏旁
石	shí<br>Variant of radical ⽯ (<b>stone</b>)<br>EXAMPLES 矸·矻·矼<br><br>HOMEPAGE ► 偏旁
石字旁	shízìpáng<br>Name of radical number 112 ⽯<br>MEANING <b>stone</b><br>EXAMPLES 矸·矻·矼<br><br>HOMEPAGE ► 偏旁
⽯	shí<br>Kangxi radical number 112<br>NAME 石字旁 shízìpáng<br>VARIANTS 石<br>STANDALONE 石<br>MEANING <b>stone</b><br>EXAMPLES 矸·矻·矼<br>MNEMONIC <i> 口 represents a rock which has rolled to the bottom of a cliff</i><br>RANK 94.4%<br>NOTES <i> Used in characters for hard, rocklike things</i><br><br>HOMEPAGE ► 偏旁
⺬	shì<br>Variant of radical ⽰ (<b>spirit</b>)<br>EXAMPLES 礼·礽·社<br><br>HOMEPAGE ► 偏旁
⺭	shì<br>Variant of radical ⽰ (<b>spirit</b>)<br>EXAMPLES 礼·礽·社<br><br>HOMEPAGE ► 偏旁
示	shì<br>Variant of radical ⽰ (<b>spirit</b>)<br>EXAMPLES 礼·礽·社<br><br>HOMEPAGE ► 偏旁
礻	shì<br>Variant of radical ⽰ (<b>spirit</b>)<br>EXAMPLES 礼·礽·社<br><br>HOMEPAGE ► 偏旁
示字旁	shìzìpáng<br>Name of radical number 113 ⽰<br>MEANING <b>spirit</b><br>EXAMPLES 礼·礽·社<br><br>HOMEPAGE ► 偏旁
⽰	shì<br>Kangxi radical number 113<br>NAME 示字旁 shìzìpáng<br>VARIANTS ⺬·⺭·示·礻<br>STANDALONE 示<br>MEANING <b>spirit</b><br>EXAMPLES 礼·礽·社<br>MNEMONIC <i> image of an altar</i><br>RANK 5.2%<br>DISTINGHUISH FROM 衤<br>NOTES <i> Also known as the SIGN radical - think divine or mystical signs.This form is not common as a character component.  Considered a separate radical from 礻in some modern simplified tables.</i><br><br>HOMEPAGE ► 偏旁
禸	róu<br>Variant of radical ⽱ (<b>track</b>)<br>EXAMPLES 禹·禺·离<br><br>HOMEPAGE ► 偏旁
⽱	róu<br>Kangxi radical number 114<br>NAME  <br>VARIANTS 禸<br>MEANING <b>track</b><br>EXAMPLES 禹·禺·离<br>MNEMONIC <i> typically indicates a rump and tail</i><br>RANK 44.4%<br><br>HOMEPAGE ► 偏旁
禾	hé<br>Variant of radical ⽲ (<b>grain</b>)<br>EXAMPLES 禿·秀·私<br><br>HOMEPAGE ► 偏旁
禾木旁	hémùpáng<br>Name of radical number 115 ⽲<br>MEANING <b>grain</b><br>EXAMPLES 禿·秀·私<br><br>HOMEPAGE ► 偏旁
⽲	hé<br>Kangxi radical number 115<br>NAME 禾木旁 hémùpáng<br>VARIANTS 禾<br>STANDALONE 禾<br>MEANING <b>grain</b><br>EXAMPLES 禿·秀·私<br>MNEMONIC <i> represents a sheath of grain with a sagging head</i><br>RANK 90.9%<br>DISTINGHUISH FROM 釆,·米,·木<br>NOTES <i> Characters relating to farming, harvesting, and of course grains contain this radical</i><br><br>HOMEPAGE ► 偏旁
穴	xué<br>Variant of radical ⽳ (<b>cave</b>)<br>EXAMPLES 究·穸·空<br><br>HOMEPAGE ► 偏旁
穴宝盖	xuébǎogài<br>Name of radical number 116 ⽳<br>MEANING <b>cave</b><br>EXAMPLES 究·穸·空<br><br>HOMEPAGE ► 偏旁
⽳	xué<br>Kangxi radical number 116<br>NAME 穴宝盖 xuébǎogài<br>VARIANTS 穴<br>STANDALONE 穴<br>MEANING <b>cave</b><br>EXAMPLES 究·穸·空<br>MNEMONIC <i> a house 宀 with an entrance 入</i><br>RANK 82.2%<br>NOTES <i> This radical is used for cave-like things and investigation</i><br><br>HOMEPAGE ► 偏旁
立	lì<br>Variant of radical ⽴ (<b>stand</b>)<br>EXAMPLES 竑·竒·竘<br><br>HOMEPAGE ► 偏旁
立字旁	lìzìpáng<br>Name of radical number 117 ⽴<br>MEANING <b>stand</b><br>EXAMPLES 竑·竒·竘<br><br>HOMEPAGE ► 偏旁
⽴	lì<br>Kangxi radical number 117<br>NAME 立字旁 lìzìpáng<br>VARIANTS 立<br>STANDALONE 立<br>MEANING <b>stand</b><br>EXAMPLES 竑·竒·竘<br>MNEMONIC <i> This is a image of a man standing on the ground, arms raised</i><br>RANK 67.7%<br><br>HOMEPAGE ► 偏旁
⺮	zhú<br>Variant of radical ⽵ (<b>bamboo</b>)<br>EXAMPLES 竺·竽·竿<br><br>HOMEPAGE ► 偏旁
竹	zhú<br>Variant of radical ⽵ (<b>bamboo</b>)<br>EXAMPLES 竺·竽·竿<br><br>HOMEPAGE ► 偏旁
𥫗	zhú<br>Variant of radical ⽵ (<b>bamboo</b>)<br>EXAMPLES 竺·竽·竿<br><br>HOMEPAGE ► 偏旁
竹字头	zhúzìtóu<br>Name of radical number 118 ⽵<br>MEANING <b>bamboo</b><br>EXAMPLES 竺·竽·竿<br><br>HOMEPAGE ► 偏旁
⽵	zhú<br>Kangxi radical number 118<br>NAME 竹字头 zhúzìtóu<br>VARIANTS ⺮·竹·𥫗<br>STANDALONE 竹<br>MEANING <b>bamboo</b><br>EXAMPLES 竺·竽·竿<br>MNEMONIC <i> Two bamboo stalks with leaves</i><br>RANK 5.2%<br>NOTES <i> Items which are or once were fashioned of bamboo are found under this radical. This full 字 isn't actually used as a component, see ⺮</i><br><br>HOMEPAGE ► 偏旁
米	mǐ<br>Variant of radical ⽶ (<b>rice</b>)<br>EXAMPLES 籸·籹·籽<br><br>HOMEPAGE ► 偏旁
米字旁	mǐzìpáng<br>Name of radical number 119 ⽶<br>MEANING <b>rice</b><br>EXAMPLES 籸·籹·籽<br><br>HOMEPAGE ► 偏旁
⽶	mǐ<br>Kangxi radical number 119<br>NAME 米字旁 mǐzìpáng<br>VARIANTS 米<br>STANDALONE 米<br>MEANING <b>rice</b><br>EXAMPLES 籸·籹·籽<br>MNEMONIC <i> Originally a picture of rice growing in a paddie, the horizontal line is the water line</i><br>RANK 85.0%<br>NOTES <i> Products of rice and their qualities are covered here, but also characters having to do with business practices and quality grades</i><br><br>HOMEPAGE ► 偏旁
⺯	mì<br>Variant of radical ⽷ (<b>silk</b>)<br>EXAMPLES 系·糾·紀<br><br>HOMEPAGE ► 偏旁
⺰	mì<br>Variant of radical ⽷ (<b>silk</b>)<br>EXAMPLES 系·糾·紀<br><br>HOMEPAGE ► 偏旁
糸	mì<br>Variant of radical ⽷ (<b>silk</b>)<br>EXAMPLES 系·糾·紀<br><br>HOMEPAGE ► 偏旁
糹	mì<br>Variant of radical ⽷ (<b>silk</b>)<br>EXAMPLES 系·糾·紀<br><br>HOMEPAGE ► 偏旁
纟	mì<br>Variant of radical ⽷ (<b>silk</b>)<br>EXAMPLES 系·糾·紀<br><br>HOMEPAGE ► 偏旁
绞丝旁	jiǎosīpáng<br>Name of radical number 120 ⽷<br>MEANING <b>silk</b><br>EXAMPLES 系·糾·紀<br><br>HOMEPAGE ► 偏旁
⽷	mì<br>Kangxi radical number 120<br>NAME 绞丝旁 jiǎosīpáng<br>VARIANTS ⺯·⺰·糸·糹·纟<br>MEANING <b>silk</b><br>EXAMPLES 系·糾·紀<br>MNEMONIC <i> twisted string</i><br>RANK 72.5%<br>DISTINGHUISH FROM 幺,·玄<br>NOTES <i> Characters having to do with rope, threads, as well as actions having to do with the manufacturing of fabrics use this radical</i><br><br>HOMEPAGE ► 偏旁
缶	fǒu<br>Variant of radical ⽸ (<b>jar</b>)<br>EXAMPLES 缸·缺·缽<br><br>HOMEPAGE ► 偏旁
⽸	fǒu<br>Kangxi radical number 121<br>NAME  <br>VARIANTS 缶<br>STANDALONE 缶<br>MEANING <b>jar</b><br>EXAMPLES 缸·缺·缽<br>MNEMONIC <i> pot with a lid</i><br>RANK 35.0%<br>NOTES <i> Earthenware vessels, jars, and their attributes use this radical</i><br><br>HOMEPAGE ► 偏旁
⺫	wǎng<br>Variant of radical ⽹ (<b>net</b>)<br>EXAMPLES 罔·罕·罘<br><br>HOMEPAGE ► 偏旁
⺱	wǎng<br>Variant of radical ⽹ (<b>net</b>)<br>EXAMPLES 罔·罕·罘<br><br>HOMEPAGE ► 偏旁
⺲	wǎng<br>Variant of radical ⽹ (<b>net</b>)<br>EXAMPLES 罔·罕·罘<br><br>HOMEPAGE ► 偏旁
⺳	wǎng<br>Variant of radical ⽹ (<b>net</b>)<br>EXAMPLES 罔·罕·罘<br><br>HOMEPAGE ► 偏旁
⺴	wǎng<br>Variant of radical ⽹ (<b>net</b>)<br>EXAMPLES 罔·罕·罘<br><br>HOMEPAGE ► 偏旁
⺵	wǎng<br>Variant of radical ⽹ (<b>net</b>)<br>EXAMPLES 罔·罕·罘<br><br>HOMEPAGE ► 偏旁
㓁	wǎng<br>Variant of radical ⽹ (<b>net</b>)<br>EXAMPLES 罔·罕·罘<br><br>HOMEPAGE ► 偏旁
网	wǎng<br>Variant of radical ⽹ (<b>net</b>)<br>EXAMPLES 罔·罕·罘<br><br>HOMEPAGE ► 偏旁
罒	wǎng<br>Variant of radical ⽹ (<b>net</b>)<br>EXAMPLES 罔·罕·罘<br><br>HOMEPAGE ► 偏旁
罓	wǎng<br>Variant of radical ⽹ (<b>net</b>)<br>EXAMPLES 罔·罕·罘<br><br>HOMEPAGE ► 偏旁
𦉫	wǎng<br>Variant of radical ⽹ (<b>net</b>)<br>EXAMPLES 罔·罕·罘<br><br>HOMEPAGE ► 偏旁
四字头	sìzìtóu<br>Name of radical number 122 ⽹<br>MEANING <b>net</b><br>EXAMPLES 罔·罕·罘<br><br>HOMEPAGE ► 偏旁
⽹	wǎng<br>Kangxi radical number 122<br>NAME 四字头 sìzìtóu<br>VARIANTS ⺫·⺱·⺲·⺳·⺴·⺵·㓁·网·罒·罓·𦉫<br>STANDALONE 网<br>MEANING <b>net</b><br>EXAMPLES 罔·罕·罘<br>RANK 5.2%<br>NOTES <i> As nets are used to trap some thing or even a person, the characters under this radical generally relate to that concept, in particular a few characters relate to crime.  Traditional form for this pronunciation is 惘, not a radical though - see 罔</i><br><br>HOMEPAGE ► 偏旁
⺶	yáng<br>Variant of radical ⽺ (<b>sheep</b>)<br>EXAMPLES 羋·羌·美<br><br>HOMEPAGE ► 偏旁
⺷	yáng<br>Variant of radical ⽺ (<b>sheep</b>)<br>EXAMPLES 羋·羌·美<br><br>HOMEPAGE ► 偏旁
⺸	yáng<br>Variant of radical ⽺ (<b>sheep</b>)<br>EXAMPLES 羋·羌·美<br><br>HOMEPAGE ► 偏旁
羊	yáng<br>Variant of radical ⽺ (<b>sheep</b>)<br>EXAMPLES 羋·羌·美<br><br>HOMEPAGE ► 偏旁
羋	yáng<br>Variant of radical ⽺ (<b>sheep</b>)<br>EXAMPLES 羋·羌·美<br><br>HOMEPAGE ► 偏旁
𦍋	yáng<br>Variant of radical ⽺ (<b>sheep</b>)<br>EXAMPLES 羋·羌·美<br><br>HOMEPAGE ► 偏旁
𦍌	yáng<br>Variant of radical ⽺ (<b>sheep</b>)<br>EXAMPLES 羋·羌·美<br><br>HOMEPAGE ► 偏旁
羊字旁	yángzìpáng<br>Name of radical number 123 ⽺<br>MEANING <b>sheep</b><br>EXAMPLES 羋·羌·美<br><br>HOMEPAGE ► 偏旁
⽺	yáng<br>Kangxi radical number 123<br>NAME 羊字旁 yángzìpáng<br>VARIANTS ⺶·⺷·⺸·羊·羋·𦍋·𦍌<br>STANDALONE 羊<br>MEANING <b>sheep</b><br>EXAMPLES 羋·羌·美<br>MNEMONIC <i> This is an image of a goat/sheep, horns, ears, and legs</i><br>RANK 52.7%<br>NOTES <i> For whatever reason, 羊 is often used as the radical virtuous or noble attributes.  Also used as the radical for a variety of grazing animals.</i><br><br>HOMEPAGE ► 偏旁
羽	yǔ<br>Variant of radical ⽻ (<b>feather</b>)<br>EXAMPLES 羿·翀·翁<br><br>HOMEPAGE ► 偏旁
羽	yǔ<br>Variant of radical ⽻ (<b>feather</b>)<br>EXAMPLES 羿·翀·翁<br><br>HOMEPAGE ► 偏旁
羽字旁	yǔzìpáng<br>Name of radical number 124 ⽻<br>MEANING <b>feather</b><br>EXAMPLES 羿·翀·翁<br><br>HOMEPAGE ► 偏旁
⽻	yǔ<br>Kangxi radical number 124<br>NAME 羽字旁 yǔzìpáng<br>VARIANTS 羽·羽<br>STANDALONE 羽<br>MEANING <b>feather</b><br>EXAMPLES 羿·翀·翁<br>MNEMONIC <i> This is an image of wings</i><br>RANK 75.3%<br>NOTES <i> Birdlike attributes, and more specifically attributes of a bird's plumage are represented by this radical.</i><br><br>HOMEPAGE ► 偏旁
⺹	lǎo<br>Variant of radical ⽼ (<b>old</b>)<br>EXAMPLES 考·者·耆<br><br>HOMEPAGE ► 偏旁
老	lǎo<br>Variant of radical ⽼ (<b>old</b>)<br>EXAMPLES 考·者·耆<br><br>HOMEPAGE ► 偏旁
耂	lǎo<br>Variant of radical ⽼ (<b>old</b>)<br>EXAMPLES 考·者·耆<br><br>HOMEPAGE ► 偏旁
老字头	lǎozìtóu<br>Name of radical number 125 ⽼<br>MEANING <b>old</b><br>EXAMPLES 考·者·耆<br><br>HOMEPAGE ► 偏旁
⽼	lǎo<br>Kangxi radical number 125<br>NAME 老字头 lǎozìtóu<br>VARIANTS ⺹·老·耂<br>STANDALONE 老<br>MEANING <b>old</b><br>EXAMPLES 考·者·耆<br>MNEMONIC <i> an old man with long hair leaning on a cane 匕</i><br>RANK 44.4%<br>NOTES <i> Used in characters conveying age. Not actually used as a radical, see variant</i><br><br>HOMEPAGE ► 偏旁
而	ér<br>Variant of radical ⽽ (<b>and</b>)<br>EXAMPLES 耍·耎·耏<br><br>HOMEPAGE ► 偏旁
⽽	ér<br>Kangxi radical number 126<br>NAME  <br>VARIANTS 而<br>STANDALONE 而<br>MEANING <b>and</b><br>EXAMPLES 耍·耎·耏<br>MNEMONIC <i> possibly represents a beard</i><br>RANK 35.0%<br><br>HOMEPAGE ► 偏旁
耒	lěi<br>Variant of radical ⽾ (<b>plough</b>)<br>EXAMPLES 耔·耕·耖<br><br>HOMEPAGE ► 偏旁
⽾	lěi<br>Kangxi radical number 127<br>NAME  <br>VARIANTS 耒<br>STANDALONE 耒<br>MEANING <b>plough</b><br>EXAMPLES 耔·耕·耖<br>MNEMONIC <i> A plow handle of wood and originally 3 cross lines indicating the furrows made</i><br>RANK 52.7%<br>NOTES <i> The few characters under this radical generally relate to cultivation of crops</i><br><br>HOMEPAGE ► 偏旁
耳	ěr<br>Variant of radical ⽿ (<b>ear</b>)<br>EXAMPLES 耴·耵·耷<br><br>HOMEPAGE ► 偏旁
耳字旁	ěrzìpáng<br>Name of radical number 128 ⽿<br>MEANING <b>ear</b><br>EXAMPLES 耴·耵·耷<br><br>HOMEPAGE ► 偏旁
⽿	ěr<br>Kangxi radical number 128<br>NAME 耳字旁 ěrzìpáng<br>VARIANTS 耳<br>STANDALONE 耳<br>MEANING <b>ear</b><br>EXAMPLES 耴·耵·耷<br>MNEMONIC <i> This is a picture of an ear</i><br>RANK 76.3%<br>NOTES <i> Typically associated with characters having to do with listening and comprehending</i><br><br>HOMEPAGE ► 偏旁
⺺	yù<br>Variant of radical ⾀ (<b>brush</b>)<br>EXAMPLES 肄·肆·肅<br><br>HOMEPAGE ► 偏旁
⺻	yù<br>Variant of radical ⾀ (<b>brush</b>)<br>EXAMPLES 肄·肆·肅<br><br>HOMEPAGE ► 偏旁
聿	yù<br>Variant of radical ⾀ (<b>brush</b>)<br>EXAMPLES 肄·肆·肅<br><br>HOMEPAGE ► 偏旁
肀	yù<br>Variant of radical ⾀ (<b>brush</b>)<br>EXAMPLES 肄·肆·肅<br><br>HOMEPAGE ► 偏旁
⾀	yù<br>Kangxi radical number 129<br>NAME  <br>VARIANTS ⺺·⺻·聿·肀<br>STANDALONE 聿<br>MEANING <b>brush</b><br>EXAMPLES 肄·肆·肅<br>MNEMONIC <i> a hand with a brush, drawing a pair of lines</i><br>RANK 35.0%<br><br>HOMEPAGE ► 偏旁
⺼	ròu<br>Variant of radical ⾁ (<b>meat</b>)<br>EXAMPLES 肊·肋·然<br><br>HOMEPAGE ► 偏旁
肉	ròu<br>Variant of radical ⾁ (<b>meat</b>)<br>EXAMPLES 肊·肋·然<br><br>HOMEPAGE ► 偏旁
⾁	ròu<br>Kangxi radical number 130<br>NAME  <br>VARIANTS ⺼·肉<br>STANDALONE 肉<br>MEANING <b>meat</b><br>EXAMPLES 肊·肋·然<br>MNEMONIC <i> ribs of an animal</i><br>RANK 20.1%<br>NOTES <i> Fleshy things and body parts are represented by this radical.  An additional variant of the flesh radical is the top half of 炙, representing meat over a fire. This variant can be seen in several characters</i><br><br>HOMEPAGE ► 偏旁
臣	chén<br>Variant of radical ⾂ (<b>minister</b>)<br>EXAMPLES 臤·臥·臧<br><br>HOMEPAGE ► 偏旁
𦣝	chén<br>Variant of radical ⾂ (<b>minister</b>)<br>EXAMPLES 臤·臥·臧<br><br>HOMEPAGE ► 偏旁
⾂	chén<br>Kangxi radical number 131<br>NAME  <br>VARIANTS 臣·𦣝<br>STANDALONE 臣<br>MEANING <b>minister</b><br>EXAMPLES 臤·臥·臧<br>MNEMONIC <i> a sideways version of an eye or a head</i><br>RANK 52.7%<br><br>HOMEPAGE ► 偏旁
自	zì<br>Variant of radical ⾃ (<b>self</b>)<br>EXAMPLES 臬·臭·臯<br><br>HOMEPAGE ► 偏旁
⾃	zì<br>Kangxi radical number 132<br>NAME  <br>VARIANTS 自<br>STANDALONE 自<br>MEANING <b>self</b><br>EXAMPLES 臬·臭·臯<br>MNEMONIC <i> primitive of a nose - one points to their nose when pointing at themselves</i><br>RANK 20.1%<br><br>HOMEPAGE ► 偏旁
至	zhì<br>Variant of radical ⾄ (<b>arrive</b>)<br>EXAMPLES 致·臷·臺<br><br>HOMEPAGE ► 偏旁
⾄	zhì<br>Kangxi radical number 133<br>NAME  <br>VARIANTS 至<br>STANDALONE 至<br>MEANING <b>arrive</b><br>EXAMPLES 致·臷·臺<br>MNEMONIC <i> an upside down arrow 矢 stuck in the ground where it (arrived) at after being shot</i><br>RANK 35.0%<br><br>HOMEPAGE ► 偏旁
⺽	jiù<br>Variant of radical ⾅ (<b>mortar</b>)<br>EXAMPLES 臾·臿·舁<br><br>HOMEPAGE ► 偏旁
臼	jiù<br>Variant of radical ⾅ (<b>mortar</b>)<br>EXAMPLES 臾·臿·舁<br><br>HOMEPAGE ► 偏旁
𦥑	jiù<br>Variant of radical ⾅ (<b>mortar</b>)<br>EXAMPLES 臾·臿·舁<br><br>HOMEPAGE ► 偏旁
⾅	jiù<br>Kangxi radical number 134<br>NAME  <br>VARIANTS ⺽·臼·𦥑<br>STANDALONE 臼<br>MEANING <b>mortar</b><br>EXAMPLES 臾·臿·舁<br>MNEMONIC <i> Picture of a large wood mortar for pounding rice flour ( Usu in Japanese - still in use today for making Mochi)</i><br>RANK 20.1%<br>DISTINGHUISH FROM 日,·曰,·白<br>NOTES <i> There is a variant form of this radical with 8 or 10 strokes, this variant seems to have different types of concepts placed into a mortar, such as 舉, 興, 輿 and 釁</i><br><br>HOMEPAGE ► 偏旁
舌	shé<br>Variant of radical ⾆ (<b>tongue</b>)<br>EXAMPLES 舍·舐·舑<br><br>HOMEPAGE ► 偏旁
舌字旁	shézìpáng<br>Name of radical number 135 ⾆<br>MEANING <b>tongue</b><br>EXAMPLES 舍·舐·舑<br><br>HOMEPAGE ► 偏旁
⾆	shé<br>Kangxi radical number 135<br>NAME 舌字旁 shézìpáng<br>VARIANTS 舌<br>STANDALONE 舌<br>MEANING <b>tongue</b><br>EXAMPLES 舍·舐·舑<br>MNEMONIC <i> A tongue sticking out of a mouth 口</i><br>RANK 20.1%<br>NOTES <i> Most of the characters under this radical do relate to things done with the tongue, a variant radical is 舍, which appears in words relating to housing</i><br><br>HOMEPAGE ► 偏旁
舛	chuǎn<br>Variant of radical ⾇ (<b>oppose</b>)<br>EXAMPLES 舜·舝·舞<br><br>HOMEPAGE ► 偏旁
⾇	chuǎn<br>Kangxi radical number 136<br>NAME  <br>VARIANTS 舛<br>STANDALONE 舛<br>MEANING <b>oppose</b><br>EXAMPLES 舜·舝·舞<br>MNEMONIC <i> two feet opposed</i><br>RANK 20.1%<br><br>HOMEPAGE ► 偏旁
舟	zhōu<br>Variant of radical ⾈ (<b>boat</b>)<br>EXAMPLES 舠·舡·舢<br><br>HOMEPAGE ► 偏旁
舟字旁	zhōuzìpáng<br>Name of radical number 137 ⾈<br>MEANING <b>boat</b><br>EXAMPLES 舠·舡·舢<br><br>HOMEPAGE ► 偏旁
⾈	zhōu<br>Kangxi radical number 137<br>NAME 舟字旁 zhōuzìpáng<br>VARIANTS 舟<br>STANDALONE 舟<br>MEANING <b>boat</b><br>EXAMPLES 舠·舡·舢<br>MNEMONIC <i> A primitive of a boat</i><br>RANK 72.5%<br>NOTES <i> If this is the radical, then the character more than likely has a nautical nature</i><br><br>HOMEPAGE ► 偏旁
艮	gèn<br>Variant of radical ⾉ (<b>stopping</b>)<br>EXAMPLES 良·艱<br><br>HOMEPAGE ► 偏旁
艮字旁	gènzìpáng<br>Name of radical number 138 ⾉<br>MEANING <b>stopping</b><br>EXAMPLES 良·艱<br><br>HOMEPAGE ► 偏旁
⾉	gèn<br>Kangxi radical number 138<br>NAME 艮字旁 gènzìpáng<br>VARIANTS 艮<br>STANDALONE 艮<br>MEANING <b>stopping</b><br>EXAMPLES 良·艱<br>MNEMONIC <i> A man 匕 with an eye 目 on top, originally just the mirror of 見</i><br>RANK 20.1%<br><br>HOMEPAGE ► 偏旁
色	sè<br>Variant of radical ⾊ (<b>colour</b>)<br>EXAMPLES 艳·艴·艵<br><br>HOMEPAGE ► 偏旁
⾊	sè<br>Kangxi radical number 139<br>NAME  <br>VARIANTS 色<br>STANDALONE 色<br>MEANING <b>colour</b><br>EXAMPLES 艳·艴·艵<br>MNEMONIC <i> The top portion is thought to be derived from 人, the bottom derived from the character for seal - 卩, so color is the thing a man chooses when he places his seal</i><br>RANK 20.1%<br>DISTINGHUISH FROM 邑<br><br>HOMEPAGE ► 偏旁
⺾	cǎo<br>Variant of radical ⾋ (<b>grass</b>)<br>EXAMPLES 艽·艾·芃<br><br>HOMEPAGE ► 偏旁
⺿	cǎo<br>Variant of radical ⾋ (<b>grass</b>)<br>EXAMPLES 艽·艾·芃<br><br>HOMEPAGE ► 偏旁
⻀	cǎo<br>Variant of radical ⾋ (<b>grass</b>)<br>EXAMPLES 艽·艾·芃<br><br>HOMEPAGE ► 偏旁
艸	cǎo<br>Variant of radical ⾋ (<b>grass</b>)<br>EXAMPLES 艽·艾·芃<br><br>HOMEPAGE ► 偏旁
艹	cǎo<br>Variant of radical ⾋ (<b>grass</b>)<br>EXAMPLES 艽·艾·芃<br><br>HOMEPAGE ► 偏旁
艹	cǎo<br>Variant of radical ⾋ (<b>grass</b>)<br>EXAMPLES 艽·艾·芃<br><br>HOMEPAGE ► 偏旁
草字头	cǎozìtóu<br>Name of radical number 140 ⾋<br>MEANING <b>grass</b><br>EXAMPLES 艽·艾·芃<br><br>HOMEPAGE ► 偏旁
⾋	cǎo<br>Kangxi radical number 140<br>NAME 草字头 cǎozìtóu<br>VARIANTS ⺾·⺿·⻀·艸·艹·艹<br>MEANING <b>grass</b><br>EXAMPLES 艽·艾·芃<br>MNEMONIC <i> Two plants of grass</i><br>RANK 0.0%<br>NOTES <i> AKA 草字頭, the grass radical covers most all flora and fauna, as well as things like medicine, arts, and crafts which come from manipulating the natural world.</i><br><br>HOMEPAGE ► 偏旁
⻁	hū<br>Variant of radical ⾌ (<b>tiger</b>)<br>EXAMPLES 虎·虐·虒<br><br>HOMEPAGE ► 偏旁
虍	hū<br>Variant of radical ⾌ (<b>tiger</b>)<br>EXAMPLES 虎·虐·虒<br><br>HOMEPAGE ► 偏旁
虎	hū<br>Variant of radical ⾌ (<b>tiger</b>)<br>EXAMPLES 虎·虐·虒<br><br>HOMEPAGE ► 偏旁
⾌	hū<br>Kangxi radical number 141<br>NAME  <br>VARIANTS ⻁·虍·虎<br>STANDALONE 虎<br>MEANING <b>tiger</b><br>EXAMPLES 虎·虐·虒<br>MNEMONIC <i> A tigers head pointing left</i><br>RANK 52.7%<br><br>HOMEPAGE ► 偏旁
虫	chóng<br>Variant of radical ⾍ (<b>insect</b>)<br>EXAMPLES 虬·虯·虱<br><br>HOMEPAGE ► 偏旁
虫字旁	chóngzìpáng<br>Name of radical number 142 ⾍<br>MEANING <b>insect</b><br>EXAMPLES 虬·虯·虱<br><br>HOMEPAGE ► 偏旁
⾍	chóng<br>Kangxi radical number 142<br>NAME 虫字旁 chóngzìpáng<br>VARIANTS 虫<br>STANDALONE 虫<br>MEANING <b>insect</b><br>EXAMPLES 虬·虯·虱<br>MNEMONIC <i> picture of a snake</i><br>RANK 93.0%<br>NOTES <i> This radical covers all things of the insect kingdom along with the insect-like crustacea.  Originally a snake, this character eventually came to represent insects. This is an alternate of 蟲</i><br><br>HOMEPAGE ► 偏旁
血	xuè<br>Variant of radical ⾎ (<b>blood</b>)<br>EXAMPLES 衁·衂·衃<br><br>HOMEPAGE ► 偏旁
⾎	xuè<br>Kangxi radical number 143<br>NAME  <br>VARIANTS 血<br>STANDALONE 血<br>MEANING <b>blood</b><br>EXAMPLES 衁·衂·衃<br>MNEMONIC <i> A bowl 皿 of blood</i><br>RANK 20.1%<br><br>HOMEPAGE ► 偏旁
行	xíng<br>Variant of radical ⾏ (<b>walk enclosure</b>)<br>EXAMPLES 衍·衎·衒<br><br>HOMEPAGE ► 偏旁
⾏	xíng<br>Kangxi radical number 144<br>NAME  <br>VARIANTS 行<br>STANDALONE 行<br>MEANING <b>walk enclosure</b><br>EXAMPLES 衍·衎·衒<br>MNEMONIC <i> step 彳 + step 亍 = go 行</i><br>RANK 59.0%<br>DISTINGHUISH FROM 彳<br>NOTES <i> When this radical is used some other character component is always inserted between 彳 and 亍</i><br><br>HOMEPAGE ► 偏旁
⻂	yī<br>Variant of radical ⾐ (<b>clothes</b>)<br>EXAMPLES 初·表·衫<br><br>HOMEPAGE ► 偏旁
衣	yī<br>Variant of radical ⾐ (<b>clothes</b>)<br>EXAMPLES 初·表·衫<br><br>HOMEPAGE ► 偏旁
衤	yī<br>Variant of radical ⾐ (<b>clothes</b>)<br>EXAMPLES 初·表·衫<br><br>HOMEPAGE ► 偏旁
𧘇	yī<br>Variant of radical ⾐ (<b>clothes</b>)<br>EXAMPLES 初·表·衫<br><br>HOMEPAGE ► 偏旁
衣字旁	yīzìpáng<br>Name of radical number 145 ⾐<br>MEANING <b>clothes</b><br>EXAMPLES 初·表·衫<br><br>HOMEPAGE ► 偏旁
⾐	yī<br>Kangxi radical number 145<br>NAME 衣字旁 yīzìpáng<br>VARIANTS ⻂·衣·衤·𧘇<br>STANDALONE 衣<br>MEANING <b>clothes</b><br>EXAMPLES 初·表·衫<br>MNEMONIC <i> cloth top indicating shoulders and head, bottom indicating flaps or folds</i><br>RANK 79.1%<br>NOTES <i> Used for different articles of clothing as well as specific parts of garments</i><br><br>HOMEPAGE ► 偏旁
⻃	yà<br>Variant of radical ⾑ (<b>cover</b>)<br>EXAMPLES 西·要·覂<br><br>HOMEPAGE ► 偏旁
⻄	yà<br>Variant of radical ⾑ (<b>cover</b>)<br>EXAMPLES 西·要·覂<br><br>HOMEPAGE ► 偏旁
襾	yà<br>Variant of radical ⾑ (<b>cover</b>)<br>EXAMPLES 西·要·覂<br><br>HOMEPAGE ► 偏旁
西	yà<br>Variant of radical ⾑ (<b>cover</b>)<br>EXAMPLES 西·要·覂<br><br>HOMEPAGE ► 偏旁
覀	yà<br>Variant of radical ⾑ (<b>cover</b>)<br>EXAMPLES 西·要·覂<br><br>HOMEPAGE ► 偏旁
⾑	yà<br>Kangxi radical number 146<br>NAME  <br>VARIANTS ⻃·⻄·襾·西·覀<br>STANDALONE 襾<br>MEANING <b>cover</b><br>EXAMPLES 西·要·覂<br>MNEMONIC <i> a picture of a stopper in a jar</i><br>RANK 0.0%<br><br>HOMEPAGE ► 偏旁
⻅	jiàn<br>Variant of radical ⾒ (<b>see</b>)<br>EXAMPLES 規·覓·視<br><br>HOMEPAGE ► 偏旁
見	jiàn<br>Variant of radical ⾒ (<b>see</b>)<br>EXAMPLES 規·覓·視<br><br>HOMEPAGE ► 偏旁
见	jiàn<br>Variant of radical ⾒ (<b>see</b>)<br>EXAMPLES 規·覓·視<br><br>HOMEPAGE ► 偏旁
见字旁	jiànzìpáng<br>Name of radical number 147 ⾒<br>MEANING <b>see</b><br>EXAMPLES 規·覓·視<br><br>HOMEPAGE ► 偏旁
⾒	jiàn<br>Kangxi radical number 147<br>NAME 见字旁 jiànzìpáng<br>VARIANTS ⻅·見·见<br>STANDALONE 见<br>MEANING <b>see</b><br>EXAMPLES 規·覓·視<br><br>HOMEPAGE ► 偏旁
⻆	jiǎo<br>Variant of radical ⾓ (<b>horn</b>)<br>EXAMPLES 觓·觔·觕<br><br>HOMEPAGE ► 偏旁
⻇	jiǎo<br>Variant of radical ⾓ (<b>horn</b>)<br>EXAMPLES 觓·觔·觕<br><br>HOMEPAGE ► 偏旁
角	jiǎo<br>Variant of radical ⾓ (<b>horn</b>)<br>EXAMPLES 觓·觔·觕<br><br>HOMEPAGE ► 偏旁
𧢲	jiǎo<br>Variant of radical ⾓ (<b>horn</b>)<br>EXAMPLES 觓·觔·觕<br><br>HOMEPAGE ► 偏旁
⾓	jiǎo<br>Kangxi radical number 148<br>NAME  <br>VARIANTS ⻆·⻇·角·𧢲<br>STANDALONE 角<br>MEANING <b>horn</b><br>EXAMPLES 觓·觔·觕<br>MNEMONIC <i> image of an animal horn</i><br>RANK 35.0%<br><br>HOMEPAGE ► 偏旁
⻈	yán<br>Variant of radical ⾔ (<b>speech</b>)<br>EXAMPLES 訂·訃·計<br><br>HOMEPAGE ► 偏旁
言	yán<br>Variant of radical ⾔ (<b>speech</b>)<br>EXAMPLES 訂·訃·計<br><br>HOMEPAGE ► 偏旁
訁	yán<br>Variant of radical ⾔ (<b>speech</b>)<br>EXAMPLES 訂·訃·計<br><br>HOMEPAGE ► 偏旁
讠	yán<br>Variant of radical ⾔ (<b>speech</b>)<br>EXAMPLES 訂·訃·計<br><br>HOMEPAGE ► 偏旁
言字旁	yánzìpáng<br>Name of radical number 149 ⾔<br>MEANING <b>speech</b><br>EXAMPLES 訂·訃·計<br><br>HOMEPAGE ► 偏旁
⾔	yán<br>Kangxi radical number 149<br>NAME 言字旁 yánzìpáng<br>VARIANTS ⻈·言·訁·讠<br>STANDALONE 言<br>MEANING <b>speech</b><br>EXAMPLES 訂·訃·計<br>MNEMONIC <i> a mouth and tongue with words on it</i><br>RANK 66.3%<br><br>HOMEPAGE ► 偏旁
谷	gǔ<br>Variant of radical ⾕ (<b>valley</b>)<br>EXAMPLES 谹·谽·谿<br><br>HOMEPAGE ► 偏旁
⾕	gǔ<br>Kangxi radical number 150<br>NAME  <br>VARIANTS 谷<br>STANDALONE 谷<br>MEANING <b>valley</b><br>EXAMPLES 谹·谽·谿<br>MNEMONIC <i> water flowing forth 八八 from an opening 口</i><br>RANK 20.1%<br><br>HOMEPAGE ► 偏旁
豆	dòu<br>Variant of radical ⾖ (<b>bean</b>)<br>EXAMPLES 豇·豈·豉<br><br>HOMEPAGE ► 偏旁
⾖	dòu<br>Kangxi radical number 151<br>NAME  <br>VARIANTS 豆<br>STANDALONE 豆<br>MEANING <b>bean</b><br>EXAMPLES 豇·豈·豉<br>MNEMONIC <i> a steamed rice container on a stand - loaned it's sound</i><br>RANK 20.1%<br>NOTES <i> Few characters are categorized under this radical, most have no clear relationship to beans</i><br><br>HOMEPAGE ► 偏旁
豕	shǐ<br>Variant of radical ⾗ (<b>pig</b>)<br>EXAMPLES 豗·豚·豜<br><br>HOMEPAGE ► 偏旁
⾗	shǐ<br>Kangxi radical number 152<br>NAME  <br>VARIANTS 豕<br>STANDALONE 豕<br>MEANING <b>pig</b><br>EXAMPLES 豗·豚·豜<br>MNEMONIC <i> This is a picture, head is replaced by the horizontal line on top</i><br>RANK 44.4%<br>DISTINGHUISH FROM 豸,·犭<br>NOTES <i> Mostly covers swine related terminology</i><br><br>HOMEPAGE ► 偏旁
豸	zhì<br>Variant of radical ⾘ (<b>badger</b>)<br>EXAMPLES 豺·豻·豹<br><br>HOMEPAGE ► 偏旁
⾘	zhì<br>Kangxi radical number 153<br>NAME  <br>VARIANTS 豸<br>MEANING <b>badger</b><br>EXAMPLES 豺·豻·豹<br>MNEMONIC <i> primitive of a small animal, possibly a reptile</i><br>RANK 44.4%<br>DISTINGHUISH FROM 豕,·犭<br>NOTES <i> Tends to cover a variety of wild and mythical animals, with the large cats seeing heavy representation</i><br><br>HOMEPAGE ► 偏旁
⻉	bèi<br>Variant of radical ⾙ (<b>shell</b>)<br>EXAMPLES 貞·負·財<br><br>HOMEPAGE ► 偏旁
貝	bèi<br>Variant of radical ⾙ (<b>shell</b>)<br>EXAMPLES 貞·負·財<br><br>HOMEPAGE ► 偏旁
贝	bèi<br>Variant of radical ⾙ (<b>shell</b>)<br>EXAMPLES 貞·負·財<br><br>HOMEPAGE ► 偏旁
贝字旁	bèizìpáng<br>Name of radical number 154 ⾙<br>MEANING <b>shell</b><br>EXAMPLES 貞·負·財<br><br>HOMEPAGE ► 偏旁
⾙	bèi<br>Kangxi radical number 154<br>NAME 贝字旁 bèizìpáng<br>VARIANTS ⻉·貝·贝<br>STANDALONE 贝<br>MEANING <b>shell</b><br>EXAMPLES 貞·負·財<br><br>HOMEPAGE ► 偏旁
赤	chì<br>Variant of radical ⾚ (<b>red</b>)<br>EXAMPLES 赦·赧·赨<br><br>HOMEPAGE ► 偏旁
⾚	chì<br>Kangxi radical number 155<br>NAME  <br>VARIANTS 赤<br>STANDALONE 赤<br>MEANING <b>red</b><br>EXAMPLES 赦·赧·赨<br>MNEMONIC <i> 土 in this character was originally 大, representing a person over a fire - 火, put them together and you have a red blushing or angry person</i><br>RANK 35.0%<br><br>HOMEPAGE ► 偏旁
走	zǒu<br>Variant of radical ⾛ (<b>run</b>)<br>EXAMPLES 赳·赴·赶<br><br>HOMEPAGE ► 偏旁
赱	zǒu<br>Variant of radical ⾛ (<b>run</b>)<br>EXAMPLES 赳·赴·赶<br><br>HOMEPAGE ► 偏旁
走字旁	zǒuzìpáng<br>Name of radical number 156 ⾛<br>MEANING <b>run</b><br>EXAMPLES 赳·赴·赶<br><br>HOMEPAGE ► 偏旁
⾛	zǒu<br>Kangxi radical number 156<br>NAME 走字旁 zǒuzìpáng<br>VARIANTS 走·赱<br>STANDALONE 走<br>MEANING <b>run</b><br>EXAMPLES 赳·赴·赶<br>MNEMONIC <i> a man 土大 with foot 止</i><br>RANK 72.5%<br>NOTES <i> Many characters relating to human motion through walking, running use this radical</i><br><br>HOMEPAGE ► 偏旁
⻊	zú<br>Variant of radical ⾜ (<b>foot</b>)<br>EXAMPLES 趴·趵·趷<br><br>HOMEPAGE ► 偏旁
足	zú<br>Variant of radical ⾜ (<b>foot</b>)<br>EXAMPLES 趴·趵·趷<br><br>HOMEPAGE ► 偏旁
𧾷	zú<br>Variant of radical ⾜ (<b>foot</b>)<br>EXAMPLES 趴·趵·趷<br><br>HOMEPAGE ► 偏旁
足字旁	zúzìpáng<br>Name of radical number 157 ⾜<br>MEANING <b>foot</b><br>EXAMPLES 趴·趵·趷<br><br>HOMEPAGE ► 偏旁
⾜	zú<br>Kangxi radical number 157<br>NAME 足字旁 zúzìpáng<br>VARIANTS ⻊·足·𧾷<br>STANDALONE 足<br>MEANING <b>foot</b><br>EXAMPLES 趴·趵·趷<br>MNEMONIC <i> a foot and a leg</i><br>RANK 5.2%<br>NOTES <i> Used for actions done with the foot</i><br><br>HOMEPAGE ► 偏旁
身	shēn<br>Variant of radical ⾝ (<b>body</b>)<br>EXAMPLES 躬·躭·躰<br><br>HOMEPAGE ► 偏旁
⾝	shēn<br>Kangxi radical number 158<br>NAME  <br>VARIANTS 身<br>STANDALONE 身<br>MEANING <b>body</b><br>EXAMPLES 躬·躭·躰<br>MNEMONIC <i> a body with stomach and leg walking</i><br>RANK 52.7%<br>NOTES <i> This radical represents things having to do with the body or actions one might take with it.</i><br><br>HOMEPAGE ► 偏旁
⻋	chē<br>Variant of radical ⾞ (<b>cart</b>)<br>EXAMPLES 軋·軌·軍<br><br>HOMEPAGE ► 偏旁
車	chē<br>Variant of radical ⾞ (<b>cart</b>)<br>EXAMPLES 軋·軌·軍<br><br>HOMEPAGE ► 偏旁
车	chē<br>Variant of radical ⾞ (<b>cart</b>)<br>EXAMPLES 軋·軌·軍<br><br>HOMEPAGE ► 偏旁
车字旁	chēzìpáng<br>Name of radical number 159 ⾞<br>MEANING <b>cart</b><br>EXAMPLES 軋·軌·軍<br><br>HOMEPAGE ► 偏旁
⾞	chē<br>Kangxi radical number 159<br>NAME 车字旁 chēzìpáng<br>VARIANTS ⻋·車·车<br>STANDALONE 车<br>MEANING <b>cart</b><br>EXAMPLES 軋·軌·軍<br><br>HOMEPAGE ► 偏旁
辛	xīn<br>Variant of radical ⾟ (<b>bitter</b>)<br>EXAMPLES 辜·辝·辟<br><br>HOMEPAGE ► 偏旁
辛字旁	xīnzìpáng<br>Name of radical number 160 ⾟<br>MEANING <b>bitter</b><br>EXAMPLES 辜·辝·辟<br><br>HOMEPAGE ► 偏旁
⾟	xīn<br>Kangxi radical number 160<br>NAME 辛字旁 xīnzìpáng<br>VARIANTS 辛<br>STANDALONE 辛<br>MEANING <b>bitter</b><br>EXAMPLES 辜·辝·辟<br>MNEMONIC <i> The lower part (below 亠) means 'to oppose', 亠 in this context may mean superiors or that above. Another interperation is this is an upside down person, with all the negative connotations of a person who may be in that position</i><br>RANK 52.7%<br>DISTINGHUISH FROM 幸<br>NOTES <i> Duplicated in many characters, like 辩.  It's bitter connotations reveal themselves in many characters, as do the connotations of hard work and suffering.</i><br><br>HOMEPAGE ► 偏旁
辰	chén<br>Variant of radical ⾠ (<b>morning</b>)<br>EXAMPLES 辱·農·辴<br><br>HOMEPAGE ► 偏旁
⾠	chén<br>Kangxi radical number 161<br>NAME  <br>VARIANTS 辰<br>STANDALONE 辰<br>MEANING <b>morning</b><br>EXAMPLES 辱·農·辴<br>MNEMONIC <i> A man handling an Egyptian hoe</i><br>RANK 20.1%<br><br>HOMEPAGE ► 偏旁
⻌	chuò<br>Variant of radical ⾡ (<b>walk</b>)<br>EXAMPLES 边·巡·迂<br><br>HOMEPAGE ► 偏旁
⻍	chuò<br>Variant of radical ⾡ (<b>walk</b>)<br>EXAMPLES 边·巡·迂<br><br>HOMEPAGE ► 偏旁
⻎	chuò<br>Variant of radical ⾡ (<b>walk</b>)<br>EXAMPLES 边·巡·迂<br><br>HOMEPAGE ► 偏旁
辵	chuò<br>Variant of radical ⾡ (<b>walk</b>)<br>EXAMPLES 边·巡·迂<br><br>HOMEPAGE ► 偏旁
辶	chuò<br>Variant of radical ⾡ (<b>walk</b>)<br>EXAMPLES 边·巡·迂<br><br>HOMEPAGE ► 偏旁
走之底	zǒuzhīdǐ<br>Name of radical number 162 ⾡<br>MEANING <b>walk</b><br>EXAMPLES 边·巡·迂<br><br>HOMEPAGE ► 偏旁
⾡	chuò<br>Kangxi radical number 162<br>NAME 走之底 zǒuzhīdǐ<br>VARIANTS ⻌·⻍·⻎·辵·辶<br>STANDALONE 辵<br>MEANING <b>walk</b><br>EXAMPLES 边·巡·迂<br>MNEMONIC <i>  辶辵 foot prints 止 on a road 彳</i><br>RANK 5.2%<br>NOTES <i> This form is not used, see 辶</i><br><br>HOMEPAGE ► 偏旁
⻏	yì<br>Variant of radical ⾢ (<b>city</b>)<br>EXAMPLES 邕·邗·邘<br><br>HOMEPAGE ► 偏旁
邑	yì<br>Variant of radical ⾢ (<b>city</b>)<br>EXAMPLES 邕·邗·邘<br><br>HOMEPAGE ► 偏旁
右耳朵	yòuěrduǒ<br>Name of radical number 163 ⾢<br>MEANING <b>city</b><br>EXAMPLES 邕·邗·邘<br><br>HOMEPAGE ► 偏旁
⾢	yì<br>Kangxi radical number 163<br>NAME 右耳朵 yòuěrduǒ<br>VARIANTS ⻏·邑<br>STANDALONE 邑<br>MEANING <b>city</b><br>EXAMPLES 邕·邗·邘<br>MNEMONIC <i> A city with buildings - 口, and subservient people -卩 </i><br>RANK 5.2%<br>DISTINGHUISH FROM 色<br><br>HOMEPAGE ► 偏旁
酉	yǒu<br>Variant of radical ⾣ (<b>wine</b>)<br>EXAMPLES 酊·酋·酌<br><br>HOMEPAGE ► 偏旁
酉字旁	yǒuzìpáng<br>Name of radical number 164 ⾣<br>MEANING <b>wine</b><br>EXAMPLES 酊·酋·酌<br><br>HOMEPAGE ► 偏旁
⾣	yǒu<br>Kangxi radical number 164<br>NAME 酉字旁 yǒuzìpáng<br>VARIANTS 酉<br>STANDALONE 酉<br>MEANING <b>wine</b><br>EXAMPLES 酊·酋·酌<br>MNEMONIC <i> This is a picture of a jug.  Another ancient form was 丣, representing the handles of a sealed wine jug.</i><br>RANK 86.8%<br>DISTINGHUISH FROM 西<br>NOTES <i> Used in characters relating to alcohol, celebration, and other reasons one might turn to the bottle.  Also in a few characters relating to cooking and fermented foodstuffs</i><br><br>HOMEPAGE ► 偏旁
釆	biàn<br>Variant of radical ⾤ (<b>distinguish</b>)<br>EXAMPLES 采·釉·釋<br><br>HOMEPAGE ► 偏旁
⾤	biàn<br>Kangxi radical number 165<br>NAME  <br>VARIANTS 釆<br>STANDALONE 釆<br>MEANING <b>distinguish</b><br>EXAMPLES 采·釉·釋<br>MNEMONIC <i> Represents sorting the rocks out of rice</i><br>RANK 35.0%<br>DISTINGHUISH FROM 米,·禾,·木<br>NOTES <i> Used in few characters, among others, those for weight, quantity, and distance</i><br><br>HOMEPAGE ► 偏旁
里	lǐ<br>Variant of radical ⾥ (<b>village</b>)<br>EXAMPLES 重·野·量<br><br>HOMEPAGE ► 偏旁
里字旁	lǐzìpáng<br>Name of radical number 166 ⾥<br>MEANING <b>village</b><br>EXAMPLES 重·野·量<br><br>HOMEPAGE ► 偏旁
⾥	lǐ<br>Kangxi radical number 166<br>NAME 里字旁 lǐzìpáng<br>VARIANTS 里<br>STANDALONE 里<br>MEANING <b>village</b><br>EXAMPLES 重·野·量<br>MNEMONIC <i> a measurement or combination of land 土 and fields 田</i><br>RANK 44.4%<br>DISTINGHUISH FROM cai3<br><br>HOMEPAGE ► 偏旁
⻐	jīn<br>Variant of radical ⾦ (<b>gold</b>)<br>EXAMPLES 釓·釔·釕<br><br>HOMEPAGE ► 偏旁
金	jīn<br>Variant of radical ⾦ (<b>gold</b>)<br>EXAMPLES 釓·釔·釕<br><br>HOMEPAGE ► 偏旁
釒	jīn<br>Variant of radical ⾦ (<b>gold</b>)<br>EXAMPLES 釓·釔·釕<br><br>HOMEPAGE ► 偏旁
钅	jīn<br>Variant of radical ⾦ (<b>gold</b>)<br>EXAMPLES 釓·釔·釕<br><br>HOMEPAGE ► 偏旁
金字旁	jīnzìpáng<br>Name of radical number 167 ⾦<br>MEANING <b>gold</b><br>EXAMPLES 釓·釔·釕<br><br>HOMEPAGE ► 偏旁
⾦	jīn<br>Kangxi radical number 167<br>NAME 金字旁 jīnzìpáng<br>VARIANTS ⻐·金·釒·钅<br>STANDALONE 金<br>MEANING <b>gold</b><br>EXAMPLES 釓·釔·釕<br>MNEMONIC <i> This represents a cast musical metal bell of the ancient variety seen in China, with bumps on the outside</i><br>RANK 35.0%<br>NOTES <i> Many characters relating to metal, metal objects, and valuable items use this radical</i><br><br>HOMEPAGE ► 偏旁
⻑	cháng<br>Variant of radical ⾧ (<b>long</b>)<br>EXAMPLES 镺·镻·镼<br><br>HOMEPAGE ► 偏旁
⻒	cháng<br>Variant of radical ⾧ (<b>long</b>)<br>EXAMPLES 镺·镻·镼<br><br>HOMEPAGE ► 偏旁
⻓	cháng<br>Variant of radical ⾧ (<b>long</b>)<br>EXAMPLES 镺·镻·镼<br><br>HOMEPAGE ► 偏旁
長	cháng<br>Variant of radical ⾧ (<b>long</b>)<br>EXAMPLES 镺·镻·镼<br><br>HOMEPAGE ► 偏旁
镸	cháng<br>Variant of radical ⾧ (<b>long</b>)<br>EXAMPLES 镺·镻·镼<br><br>HOMEPAGE ► 偏旁
长	cháng<br>Variant of radical ⾧ (<b>long</b>)<br>EXAMPLES 镺·镻·镼<br><br>HOMEPAGE ► 偏旁
⾧	cháng<br>Kangxi radical number 168<br>NAME  <br>VARIANTS ⻑·⻒·⻓·長·镸·长<br>STANDALONE 长<br>MEANING <b>long</b><br>EXAMPLES 镺·镻·镼<br><br>HOMEPAGE ► 偏旁
⻔	mén<br>Variant of radical ⾨ (<b>gate</b>)<br>EXAMPLES 閂·閃·閆<br><br>HOMEPAGE ► 偏旁
門	mén<br>Variant of radical ⾨ (<b>gate</b>)<br>EXAMPLES 閂·閃·閆<br><br>HOMEPAGE ► 偏旁
门	mén<br>Variant of radical ⾨ (<b>gate</b>)<br>EXAMPLES 閂·閃·閆<br><br>HOMEPAGE ► 偏旁
门字框	ménzìkuàng<br>Name of radical number 169 ⾨<br>MEANING <b>gate</b><br>EXAMPLES 閂·閃·閆<br><br>HOMEPAGE ► 偏旁
⾨	mén<br>Kangxi radical number 169<br>NAME 门字框 ménzìkuàng<br>VARIANTS ⻔·門·门<br>STANDALONE 门<br>MEANING <b>gate</b><br>EXAMPLES 閂·閃·閆<br><br>HOMEPAGE ► 偏旁
⻕	fù<br>Variant of radical ⾩ (<b>mound</b>)<br>EXAMPLES 阞·阡·阢<br><br>HOMEPAGE ► 偏旁
⻖	fù<br>Variant of radical ⾩ (<b>mound</b>)<br>EXAMPLES 阞·阡·阢<br><br>HOMEPAGE ► 偏旁
阜	fù<br>Variant of radical ⾩ (<b>mound</b>)<br>EXAMPLES 阞·阡·阢<br><br>HOMEPAGE ► 偏旁
阝	fù<br>Variant of radical ⾩ (<b>mound</b>)<br>EXAMPLES 阞·阡·阢<br><br>HOMEPAGE ► 偏旁
𨸏	fù<br>Variant of radical ⾩ (<b>mound</b>)<br>EXAMPLES 阞·阡·阢<br><br>HOMEPAGE ► 偏旁
双耳刀	shuāngěrdāo<br>Name of radical number 170 ⾩<br>MEANING <b>mound</b><br>EXAMPLES 阞·阡·阢<br><br>HOMEPAGE ► 偏旁
左耳刀	zuǒěrdāo<br>Name of radical number 170 ⾩<br>MEANING <b>mound</b><br>EXAMPLES 阞·阡·阢<br><br>HOMEPAGE ► 偏旁
⾩	fù<br>Kangxi radical number 170<br>NAME 双耳刀 shuāngěrdāo·左耳刀 zuǒěrdāo<br>VARIANTS ⻕·⻖·阜·阝·𨸏<br>STANDALONE 阜<br>MEANING <b>mound</b><br>EXAMPLES 阞·阡·阢<br>MNEMONIC <i> Represents steps coming down from a city, or possiby a wall</i><br>RANK 5.2%<br>NOTES <i> Rare variant.  If one things of something like the great wall as the ultimate mound, a lot of the characters under this radical make quite a bit of sense</i><br><br>HOMEPAGE ► 偏旁
隶	lì<br>Variant of radical ⾪ (<b>slave</b>)<br>EXAMPLES 𨽻·隷·隸<br><br>HOMEPAGE ► 偏旁
⾪	lì<br>Kangxi radical number 171<br>NAME  <br>VARIANTS 隶<br>STANDALONE 隶<br>MEANING <b>slave</b><br>EXAMPLES 𨽻·隷·隸<br>MNEMONIC <i> a subordinate who has a futile 柰 life with a broom 隶</i><br>RANK 5.2%<br><br>HOMEPAGE ► 偏旁
隹	zhuī<br>Variant of radical ⾫ (<b>short-tailed bird</b>)<br>EXAMPLES 隻·隼·隽<br><br>HOMEPAGE ► 偏旁
隹字旁	zhūizìpáng<br>Name of radical number 172 ⾫<br>MEANING <b>short-tailed bird</b><br>EXAMPLES 隻·隼·隽<br><br>HOMEPAGE ► 偏旁
⾫	zhuī<br>Kangxi radical number 172<br>NAME 隹字旁 zhūizìpáng<br>VARIANTS 隹<br>STANDALONE 隹<br>MEANING <b>short-tailed bird</b><br>EXAMPLES 隻·隼·隽<br>MNEMONIC <i> A small bird, wings outstretched</i><br>RANK 72.5%<br>NOTES <i> Smaller birds are under this radical, as are a lot of characters which don't immediately make one think of birds.</i><br><br>HOMEPAGE ► 偏旁
⻗	yǔ<br>Variant of radical ⾬ (<b>rain</b>)<br>EXAMPLES 雩·雪·雯<br><br>HOMEPAGE ► 偏旁
雨	yǔ<br>Variant of radical ⾬ (<b>rain</b>)<br>EXAMPLES 雩·雪·雯<br><br>HOMEPAGE ► 偏旁
雨字头	yǔzìtóu<br>Name of radical number 173 ⾬<br>MEANING <b>rain</b><br>EXAMPLES 雩·雪·雯<br><br>HOMEPAGE ► 偏旁
⾬	yǔ<br>Kangxi radical number 173<br>NAME 雨字头 yǔzìtóu<br>VARIANTS ⻗·雨<br>STANDALONE 雨<br>MEANING <b>rain</b><br>EXAMPLES 雩·雪·雯<br>MNEMONIC <i> Rain drops falling from sky</i><br>RANK 81.2%<br>NOTES <i> Characters representing various climate and weather conditions are represented here</i><br><br>HOMEPAGE ► 偏旁
⻘	qīng<br>Variant of radical ⾭ (<b>blue</b>)<br>EXAMPLES 靖·静·靚<br><br>HOMEPAGE ► 偏旁
靑	qīng<br>Variant of radical ⾭ (<b>blue</b>)<br>EXAMPLES 靖·静·靚<br><br>HOMEPAGE ► 偏旁
青	qīng<br>Variant of radical ⾭ (<b>blue</b>)<br>EXAMPLES 靖·静·靚<br><br>HOMEPAGE ► 偏旁
青字旁	qīngzìpáng<br>Name of radical number 174 ⾭<br>MEANING <b>blue</b><br>EXAMPLES 靖·静·靚<br><br>HOMEPAGE ► 偏旁
⾭	qīng<br>Kangxi radical number 174<br>NAME 青字旁 qīngzìpáng<br>VARIANTS ⻘·靑·青<br>STANDALONE 青<br>MEANING <b>blue</b><br>EXAMPLES 靖·静·靚<br>MNEMONIC <i> grass 生 around a well 井 (not 月)</i><br>RANK 0.0%<br><br>HOMEPAGE ► 偏旁
非	fēi<br>Variant of radical ⾮ (<b>wrong</b>)<br>EXAMPLES 靟·靠·靡<br><br>HOMEPAGE ► 偏旁
⾮	fēi<br>Kangxi radical number 175<br>NAME  <br>VARIANTS 非<br>STANDALONE 非<br>MEANING <b>wrong</b><br>EXAMPLES 靟·靠·靡<br>MNEMONIC <i> outward turned (broken) wings which do not function</i><br>RANK 35.0%<br>DISTINGHUISH FROM 韭<br><br>HOMEPAGE ► 偏旁
面	miàn<br>Variant of radical ⾯ (<b>face</b>)<br>EXAMPLES 靤·靦·靧<br><br>HOMEPAGE ► 偏旁
靣	miàn<br>Variant of radical ⾯ (<b>face</b>)<br>EXAMPLES 靤·靦·靧<br><br>HOMEPAGE ► 偏旁
⾯	miàn<br>Kangxi radical number 176<br>NAME  <br>VARIANTS 面·靣<br>STANDALONE 面<br>MEANING <b>face</b><br>EXAMPLES 靤·靦·靧<br>MNEMONIC <i> a face with an eye 目 in the middle</i><br>RANK 5.2%<br><br>HOMEPAGE ► 偏旁
革	gé<br>Variant of radical ⾰ (<b>leather</b>)<br>EXAMPLES 靭·靮·靳<br><br>HOMEPAGE ► 偏旁
⾰	gé<br>Kangxi radical number 177<br>NAME  <br>VARIANTS 革<br>STANDALONE 革<br>MEANING <b>leather</b><br>EXAMPLES 靭·靮·靳<br>MNEMONIC <i> Represents a spread out animal skin</i><br>RANK 67.7%<br>NOTES <i> Leather goods are categorized under this radical</i><br><br>HOMEPAGE ► 偏旁
⻙	wéi<br>Variant of radical ⾱ (<b>tanned leather</b>)<br>EXAMPLES 韌·韍·韎<br><br>HOMEPAGE ► 偏旁
韋	wéi<br>Variant of radical ⾱ (<b>tanned leather</b>)<br>EXAMPLES 韌·韍·韎<br><br>HOMEPAGE ► 偏旁
韦	wéi<br>Variant of radical ⾱ (<b>tanned leather</b>)<br>EXAMPLES 韌·韍·韎<br><br>HOMEPAGE ► 偏旁
⾱	wéi<br>Kangxi radical number 178<br>NAME  <br>VARIANTS ⻙·韋·韦<br>STANDALONE 韦<br>MEANING <b>tanned leather</b><br>EXAMPLES 韌·韍·韎<br><br>HOMEPAGE ► 偏旁
韭	jiǔ<br>Variant of radical ⾲ (<b>leek</b>)<br>EXAMPLES 韰·韲·䪢<br><br>HOMEPAGE ► 偏旁
⾲	jiǔ<br>Kangxi radical number 179<br>NAME  <br>VARIANTS 韭<br>STANDALONE 韭<br>MEANING <b>leek</b><br>EXAMPLES 韰·韲·䪢<br>MNEMONIC <i> an ideograph of leeks</i><br>RANK 5.2%<br>DISTINGHUISH FROM 非<br><br>HOMEPAGE ► 偏旁
音	yīn<br>Variant of radical ⾳ (<b>sound</b>)<br>EXAMPLES 竟·章·韵<br><br>HOMEPAGE ► 偏旁
⾳	yīn<br>Kangxi radical number 180<br>NAME  <br>VARIANTS 音<br>STANDALONE 音<br>MEANING <b>sound</b><br>EXAMPLES 竟·章·韵<br>MNEMONIC <i> a mouth with something in it and a tongue sticking out with something on it</i><br>RANK 44.4%<br><br>HOMEPAGE ► 偏旁
⻚	yè<br>Variant of radical ⾴ (<b>leaf</b>)<br>EXAMPLES 頂·頃·頄<br><br>HOMEPAGE ► 偏旁
頁	yè<br>Variant of radical ⾴ (<b>leaf</b>)<br>EXAMPLES 頂·頃·頄<br><br>HOMEPAGE ► 偏旁
页	yè<br>Variant of radical ⾴ (<b>leaf</b>)<br>EXAMPLES 頂·頃·頄<br><br>HOMEPAGE ► 偏旁
页字旁	yèzìpáng<br>Name of radical number 181 ⾴<br>MEANING <b>leaf</b><br>EXAMPLES 頂·頃·頄<br><br>HOMEPAGE ► 偏旁
⾴	yè<br>Kangxi radical number 181<br>NAME 页字旁 yèzìpáng<br>VARIANTS ⻚·頁·页<br>STANDALONE 页<br>MEANING <b>leaf</b><br>EXAMPLES 頂·頃·頄<br><br>HOMEPAGE ► 偏旁
⻛	fēng<br>Variant of radical ⾵ (<b>wind</b>)<br>EXAMPLES 颩·颭·颮<br><br>HOMEPAGE ► 偏旁
風	fēng<br>Variant of radical ⾵ (<b>wind</b>)<br>EXAMPLES 颩·颭·颮<br><br>HOMEPAGE ► 偏旁
风	fēng<br>Variant of radical ⾵ (<b>wind</b>)<br>EXAMPLES 颩·颭·颮<br><br>HOMEPAGE ► 偏旁
⾵	fēng<br>Kangxi radical number 182<br>NAME  <br>VARIANTS ⻛·風·风<br>STANDALONE 风<br>MEANING <b>wind</b><br>EXAMPLES 颩·颭·颮<br><br>HOMEPAGE ► 偏旁
⻜	fēi<br>Variant of radical ⾶ (<b>fly</b>)<br>EXAMPLES 䬡·飜·飝<br><br>HOMEPAGE ► 偏旁
飛	fēi<br>Variant of radical ⾶ (<b>fly</b>)<br>EXAMPLES 䬡·飜·飝<br><br>HOMEPAGE ► 偏旁
飞	fēi<br>Variant of radical ⾶ (<b>fly</b>)<br>EXAMPLES 䬡·飜·飝<br><br>HOMEPAGE ► 偏旁
⾶	fēi<br>Kangxi radical number 183<br>NAME  <br>VARIANTS ⻜·飛·飞<br>STANDALONE 飞<br>MEANING <b>fly</b><br>EXAMPLES 䬡·飜·飝<br><br>HOMEPAGE ► 偏旁
⻝	shí<br>Variant of radical ⾷ (<b>eat</b>)<br>EXAMPLES 飡·飢·飣<br><br>HOMEPAGE ► 偏旁
⻞	shí<br>Variant of radical ⾷ (<b>eat</b>)<br>EXAMPLES 飡·飢·飣<br><br>HOMEPAGE ► 偏旁
⻟	shí<br>Variant of radical ⾷ (<b>eat</b>)<br>EXAMPLES 飡·飢·飣<br><br>HOMEPAGE ► 偏旁
⻠	shí<br>Variant of radical ⾷ (<b>eat</b>)<br>EXAMPLES 飡·飢·飣<br><br>HOMEPAGE ► 偏旁
食	shí<br>Variant of radical ⾷ (<b>eat</b>)<br>EXAMPLES 飡·飢·飣<br><br>HOMEPAGE ► 偏旁
飠	shí<br>Variant of radical ⾷ (<b>eat</b>)<br>EXAMPLES 飡·飢·飣<br><br>HOMEPAGE ► 偏旁
饣	shí<br>Variant of radical ⾷ (<b>eat</b>)<br>EXAMPLES 飡·飢·飣<br><br>HOMEPAGE ► 偏旁
𩙿	shí<br>Variant of radical ⾷ (<b>eat</b>)<br>EXAMPLES 飡·飢·飣<br><br>HOMEPAGE ► 偏旁
食字旁	shízìpáng<br>Name of radical number 184 ⾷<br>MEANING <b>eat</b><br>EXAMPLES 飡·飢·飣<br><br>HOMEPAGE ► 偏旁
⾷	shí<br>Kangxi radical number 184<br>NAME 食字旁 shízìpáng<br>VARIANTS ⻝·⻞·⻟·⻠·食·飠·饣·𩙿<br>STANDALONE 食<br>MEANING <b>eat</b><br>EXAMPLES 飡·飢·飣<br>MNEMONIC <i> a man's mouth 亼 over a bowl of rice on a stand 皀 (the two dots combine). Note the lower part is not 艮</i><br>RANK 20.1%<br>NOTES <i> Many types of food and mealtime activities are encompassed by characters with this radical</i><br><br>HOMEPAGE ► 偏旁
⻡	shǒu<br>Variant of radical ⾸ (<b>head</b>)<br>EXAMPLES 馗·䭫·馘<br><br>HOMEPAGE ► 偏旁
首	shǒu<br>Variant of radical ⾸ (<b>head</b>)<br>EXAMPLES 馗·䭫·馘<br><br>HOMEPAGE ► 偏旁
𩠐	shǒu<br>Variant of radical ⾸ (<b>head</b>)<br>EXAMPLES 馗·䭫·馘<br><br>HOMEPAGE ► 偏旁
⾸	shǒu<br>Kangxi radical number 185<br>NAME  <br>VARIANTS ⻡·首·𩠐<br>STANDALONE 首<br>MEANING <b>head</b><br>EXAMPLES 馗·䭫·馘<br>MNEMONIC <i> a head like 頁 but with hair on top</i><br>RANK 20.1%<br><br>HOMEPAGE ► 偏旁
香	xiāng<br>Variant of radical ⾹ (<b>fragrant</b>)<br>EXAMPLES 馝·馞·馡<br><br>HOMEPAGE ► 偏旁
⾹	xiāng<br>Kangxi radical number 186<br>NAME  <br>VARIANTS 香<br>STANDALONE 香<br>MEANING <b>fragrant</b><br>EXAMPLES 馝·馞·馡<br>MNEMONIC <i> represents nice food going in the mouth</i><br>RANK 5.2%<br><br>HOMEPAGE ► 偏旁
⻢	mǎ<br>Variant of radical ⾺ (<b>horse</b>)<br>EXAMPLES 馭·馮·馯<br><br>HOMEPAGE ► 偏旁
馬	mǎ<br>Variant of radical ⾺ (<b>horse</b>)<br>EXAMPLES 馭·馮·馯<br><br>HOMEPAGE ► 偏旁
马	mǎ<br>Variant of radical ⾺ (<b>horse</b>)<br>EXAMPLES 馭·馮·馯<br><br>HOMEPAGE ► 偏旁
马字旁	mǎzìpáng<br>Name of radical number 187 ⾺<br>MEANING <b>horse</b><br>EXAMPLES 馭·馮·馯<br><br>HOMEPAGE ► 偏旁
⾺	mǎ<br>Kangxi radical number 187<br>NAME 马字旁 mǎzìpáng<br>VARIANTS ⻢·馬·马<br>STANDALONE 马<br>MEANING <b>horse</b><br>EXAMPLES 馭·馮·馯<br><br>HOMEPAGE ► 偏旁
⻣	gǔ<br>Variant of radical ⾻ (<b>bone</b>)<br>EXAMPLES 骫·骭·骯<br><br>HOMEPAGE ► 偏旁
骨	gǔ<br>Variant of radical ⾻ (<b>bone</b>)<br>EXAMPLES 骫·骭·骯<br><br>HOMEPAGE ► 偏旁
⾻	gǔ<br>Kangxi radical number 188<br>NAME  <br>VARIANTS ⻣·骨<br>STANDALONE 骨<br>MEANING <b>bone</b><br>EXAMPLES 骫·骭·骯<br>MNEMONIC <i> scapula with the meat radical (moon variant)</i><br>RANK 35.0%<br>NOTES <i> Characters under this radical cover various body parts, and not surprisingly, bones.  Things associated with bones are also covered such as 骯髒 and 骴. Simplification has occasionally replaced 骨 with the standing meat radical (月)</i><br><br>HOMEPAGE ► 偏旁
高	gāo<br>Variant of radical ⾼ (<b>tall</b>)<br>EXAMPLES 髚·髛·𩫛<br><br>HOMEPAGE ► 偏旁
髙	gāo<br>Variant of radical ⾼ (<b>tall</b>)<br>EXAMPLES 髚·髛·𩫛<br><br>HOMEPAGE ► 偏旁
⾼	gāo<br>Kangxi radical number 189<br>NAME  <br>VARIANTS 高·髙<br>STANDALONE 高<br>MEANING <b>tall</b><br>EXAMPLES 髚·髛·𩫛<br>MNEMONIC <i> represents a high building</i><br>RANK 5.2%<br><br>HOMEPAGE ► 偏旁
髟	biāo<br>Variant of radical ⾽ (<b>hair</b>)<br>EXAMPLES 髠·髡·髢<br><br>HOMEPAGE ► 偏旁
⾽	biāo<br>Kangxi radical number 190<br>NAME  <br>VARIANTS 髟<br>STANDALONE 髟<br>MEANING <b>hair</b><br>EXAMPLES 髠·髡·髢<br>MNEMONIC <i> 長 long hair and 彡 more hair</i><br>RANK 20.1%<br>NOTES <i> Not surprisingly, shows up in characters describing all things hairy</i><br><br>HOMEPAGE ► 偏旁
鬥	dòu<br>Variant of radical ⾾ (<b>fight</b>)<br>EXAMPLES 鬦·鬧·鬨<br><br>HOMEPAGE ► 偏旁
⾾	dòu<br>Kangxi radical number 191<br>NAME  <br>VARIANTS 鬥<br>MEANING <b>fight</b><br>EXAMPLES 鬦·鬧·鬨<br><br>HOMEPAGE ► 偏旁
鬯	chàng<br>Variant of radical ⾿ (<b>sacrificial wine</b>)<br>EXAMPLES 鬰·鬱<br><br>HOMEPAGE ► 偏旁
⾿	chàng<br>Kangxi radical number 192<br>NAME  <br>VARIANTS 鬯<br>STANDALONE 鬯<br>MEANING <b>sacrificial wine</b><br>EXAMPLES 鬰·鬱<br>MNEMONIC <i> a container of rice</i><br>RANK 20.1%<br><br>HOMEPAGE ► 偏旁
鬲	lì<br>Variant of radical ⿀ (<b>cauldron</b>)<br>EXAMPLES 鬳·鬴·鬵<br><br>HOMEPAGE ► 偏旁
⿀	lì<br>Kangxi radical number 193<br>NAME  <br>VARIANTS 鬲<br>STANDALONE 鬲<br>MEANING <b>cauldron</b><br>EXAMPLES 鬳·鬴·鬵<br>MNEMONIC <i> three legged cauldron</i><br>RANK 5.2%<br><br>HOMEPAGE ► 偏旁
⻤	guǐ<br>Variant of radical ⿁ (<b>ghost</b>)<br>EXAMPLES 鬾·魁·魂<br><br>HOMEPAGE ► 偏旁
鬼	guǐ<br>Variant of radical ⿁ (<b>ghost</b>)<br>EXAMPLES 鬾·魁·魂<br><br>HOMEPAGE ► 偏旁
⿁	guǐ<br>Kangxi radical number 194<br>NAME  <br>VARIANTS ⻤·鬼<br>STANDALONE 鬼<br>MEANING <b>ghost</b><br>EXAMPLES 鬾·魁·魂<br>MNEMONIC <i> A man (goblin) with an ugly head and a tail</i><br>RANK 59.0%<br>NOTES <i> Otherworldy things tend to be represented by this radical</i><br><br>HOMEPAGE ► 偏旁
⻥	yú<br>Variant of radical ⿂ (<b>fish</b>)<br>EXAMPLES 魟·魠·魦<br><br>HOMEPAGE ► 偏旁
魚	yú<br>Variant of radical ⿂ (<b>fish</b>)<br>EXAMPLES 魟·魠·魦<br><br>HOMEPAGE ► 偏旁
鱼	yú<br>Variant of radical ⿂ (<b>fish</b>)<br>EXAMPLES 魟·魠·魦<br><br>HOMEPAGE ► 偏旁
⿂	yú<br>Kangxi radical number 195<br>NAME  <br>VARIANTS ⻥·魚·鱼<br>STANDALONE 鱼<br>MEANING <b>fish</b><br>EXAMPLES 魟·魠·魦<br><br>HOMEPAGE ► 偏旁
⻦	niǎo<br>Variant of radical ⿃ (<b>bird</b>)<br>EXAMPLES 鳦·鳧·鳩<br><br>HOMEPAGE ► 偏旁
鳥	niǎo<br>Variant of radical ⿃ (<b>bird</b>)<br>EXAMPLES 鳦·鳧·鳩<br><br>HOMEPAGE ► 偏旁
鸟	niǎo<br>Variant of radical ⿃ (<b>bird</b>)<br>EXAMPLES 鳦·鳧·鳩<br><br>HOMEPAGE ► 偏旁
鸟字旁	niǎozìpáng<br>Name of radical number 196 ⿃<br>MEANING <b>bird</b><br>EXAMPLES 鳦·鳧·鳩<br><br>HOMEPAGE ► 偏旁
⿃	niǎo<br>Kangxi radical number 196<br>NAME 鸟字旁 niǎozìpáng<br>VARIANTS ⻦·鳥·鸟<br>STANDALONE 鸟<br>MEANING <b>bird</b><br>EXAMPLES 鳦·鳧·鳩<br><br>HOMEPAGE ► 偏旁
⻧	lǔ<br>Variant of radical ⿄ (<b>salt</b>)<br>EXAMPLES 鹹·鹺·鹼<br><br>HOMEPAGE ► 偏旁
卤	lǔ<br>Variant of radical ⿄ (<b>salt</b>)<br>EXAMPLES 鹹·鹺·鹼<br><br>HOMEPAGE ► 偏旁
鹵	lǔ<br>Variant of radical ⿄ (<b>salt</b>)<br>EXAMPLES 鹹·鹺·鹼<br><br>HOMEPAGE ► 偏旁
⿄	lǔ<br>Kangxi radical number 197<br>NAME  <br>VARIANTS ⻧·卤·鹵<br>STANDALONE 卤<br>MEANING <b>salt</b><br>EXAMPLES 鹹·鹺·鹼<br><br>HOMEPAGE ► 偏旁
鹿	lù<br>Variant of radical ⿅ (<b>deer</b>)<br>EXAMPLES 麀·麁·麂<br><br>HOMEPAGE ► 偏旁
⿅	lù<br>Kangxi radical number 198<br>NAME  <br>VARIANTS 鹿<br>STANDALONE 鹿<br>MEANING <b>deer</b><br>EXAMPLES 麀·麁·麂<br>MNEMONIC <i> primitive of an antlered deer - see seal characters</i><br>RANK 20.1%<br>NOTES <i> Denotes the most attractive aspects of the wilderness and wild things</i><br><br>HOMEPAGE ► 偏旁
⻨	mài<br>Variant of radical ⿆ (<b>wheat</b>)<br>EXAMPLES 麨·麩·麪<br><br>HOMEPAGE ► 偏旁
麥	mài<br>Variant of radical ⿆ (<b>wheat</b>)<br>EXAMPLES 麨·麩·麪<br><br>HOMEPAGE ► 偏旁
麦	mài<br>Variant of radical ⿆ (<b>wheat</b>)<br>EXAMPLES 麨·麩·麪<br><br>HOMEPAGE ► 偏旁
⿆	mài<br>Kangxi radical number 199<br>NAME  <br>VARIANTS ⻨·麥·麦<br>STANDALONE 麦<br>MEANING <b>wheat</b><br>EXAMPLES 麨·麩·麪<br><br>HOMEPAGE ► 偏旁
麻	má<br>Variant of radical ⿇ (<b>hemp</b>)<br>EXAMPLES 麼·麾·黁<br><br>HOMEPAGE ► 偏旁
⿇	má<br>Kangxi radical number 200<br>NAME  <br>VARIANTS 麻<br>STANDALONE 麻<br>MEANING <b>hemp</b><br>EXAMPLES 麼·麾·黁<br>MNEMONIC <i> hemp (from 痲) in the barn  广 - separate etymology from 林</i><br>RANK 5.2%<br><br>HOMEPAGE ► 偏旁
⻩	huáng<br>Variant of radical ⿈ (<b>yellow</b>)<br>EXAMPLES 黈·䵍·黌<br><br>HOMEPAGE ► 偏旁
黃	huáng<br>Variant of radical ⿈ (<b>yellow</b>)<br>EXAMPLES 黈·䵍·黌<br><br>HOMEPAGE ► 偏旁
黄	huáng<br>Variant of radical ⿈ (<b>yellow</b>)<br>EXAMPLES 黈·䵍·黌<br><br>HOMEPAGE ► 偏旁
⿈	huáng<br>Kangxi radical number 201<br>NAME  <br>VARIANTS ⻩·黃·黄<br>STANDALONE 黄<br>MEANING <b>yellow</b><br>EXAMPLES 黈·䵍·黌<br>MNEMONIC <i> a man 大 with a (yellow) pendant, now 璜</i><br>RANK 5.2%<br><br>HOMEPAGE ► 偏旁
黍	shǔ<br>Variant of radical ⿉ (<b>millet</b>)<br>EXAMPLES 黎·黏·黐<br><br>HOMEPAGE ► 偏旁
⿉	shǔ<br>Kangxi radical number 202<br>NAME  <br>VARIANTS 黍<br>STANDALONE 黍<br>MEANING <b>millet</b><br>EXAMPLES 黎·黏·黐<br>MNEMONIC <i> grain 禾 that grows by water 水</i><br>RANK 5.2%<br><br>HOMEPAGE ► 偏旁
黑	hēi<br>Variant of radical ⿊ (<b>black</b>)<br>EXAMPLES 墨·黓·黔<br><br>HOMEPAGE ► 偏旁
黒	hēi<br>Variant of radical ⿊ (<b>black</b>)<br>EXAMPLES 墨·黓·黔<br><br>HOMEPAGE ► 偏旁
⿊	hēi<br>Kangxi radical number 203<br>NAME  <br>VARIANTS 黑·黒<br>STANDALONE 黑<br>MEANING <b>black</b><br>EXAMPLES 墨·黓·黔<br>MNEMONIC <i> black from charcoal grain in an air tight container over a fire, in early forms the bottom half was more clearly 炎</i><br>RANK 84.3%<br>NOTES <i> Primary form.  Opposite of 白, blackness can often add dark connotations to many characters</i><br><br>HOMEPAGE ► 偏旁
黹	zhǐ<br>Variant of radical ⿋ (<b>embroidery</b>)<br>EXAMPLES 黺·黻·黼<br><br>HOMEPAGE ► 偏旁
⿋	zhǐ<br>Kangxi radical number 204<br>NAME  <br>VARIANTS 黹<br>STANDALONE 黹<br>MEANING <b>embroidery</b><br>EXAMPLES 黺·黻·黼<br>MNEMONIC <i> primitive of embroidery</i><br>RANK 44.4%<br><br>HOMEPAGE ► 偏旁
⻪	mǐn<br>Variant of radical ⿌ (<b>frog</b>)<br>EXAMPLES 黿·鼀·鼁<br><br>HOMEPAGE ► 偏旁
黽	mǐn<br>Variant of radical ⿌ (<b>frog</b>)<br>EXAMPLES 黿·鼀·鼁<br><br>HOMEPAGE ► 偏旁
黾	mǐn<br>Variant of radical ⿌ (<b>frog</b>)<br>EXAMPLES 黿·鼀·鼁<br><br>HOMEPAGE ► 偏旁
⿌	mǐn<br>Kangxi radical number 205<br>NAME  <br>VARIANTS ⻪·黽·黾<br>STANDALONE 黾<br>MEANING <b>frog</b><br>EXAMPLES 黿·鼀·鼁<br><br>HOMEPAGE ► 偏旁
鼎	dǐng<br>Variant of radical ⿍ (<b>tripod</b>)<br>EXAMPLES 鼏·鼐·鼒<br><br>HOMEPAGE ► 偏旁
⿍	dǐng<br>Kangxi radical number 206<br>NAME  <br>VARIANTS 鼎<br>STANDALONE 鼎<br>MEANING <b>tripod</b><br>EXAMPLES 鼏·鼐·鼒<br>MNEMONIC <i> a bronze tripod with two ears</i><br>RANK 35.0%<br><br>HOMEPAGE ► 偏旁
鼓	gǔ<br>Variant of radical ⿎ (<b>drum</b>)<br>EXAMPLES 鼕·鼖·鼗<br><br>HOMEPAGE ► 偏旁
⿎	gǔ<br>Kangxi radical number 207<br>NAME  <br>VARIANTS 鼓<br>STANDALONE 鼓<br>MEANING <b>drum</b><br>EXAMPLES 鼕·鼖·鼗<br>MNEMONIC <i> a drum 口 left and right ends with base and feathers on top 土 hit with stick 支</i><br>RANK 35.0%<br><br>HOMEPAGE ► 偏旁
鼠	shǔ<br>Variant of radical ⿏ (<b>rat</b>)<br>EXAMPLES 鼢·鼥·鼩<br><br>HOMEPAGE ► 偏旁
鼡	shǔ<br>Variant of radical ⿏ (<b>rat</b>)<br>EXAMPLES 鼢·鼥·鼩<br><br>HOMEPAGE ► 偏旁
⿏	shǔ<br>Kangxi radical number 208<br>NAME  <br>VARIANTS 鼠·鼡<br>STANDALONE 鼠<br>MEANING <b>rat</b><br>EXAMPLES 鼢·鼥·鼩<br>MNEMONIC <i> A mouse with legs tail and whiskers</i><br>RANK 66.3%<br><br>HOMEPAGE ► 偏旁
鼻	bí<br>Variant of radical ⿐ (<b>nose</b>)<br>EXAMPLES 鼽·鼾·齁<br><br>HOMEPAGE ► 偏旁
⿐	bí<br>Kangxi radical number 209<br>NAME  <br>VARIANTS 鼻<br>STANDALONE 鼻<br>MEANING <b>nose</b><br>EXAMPLES 鼽·鼾·齁<br>MNEMONIC <i> synonym for 自 nose</i><br>RANK 44.4%<br><br>HOMEPAGE ► 偏旁
⻫	qí<br>Variant of radical ⿑ (<b>even</b>)<br>EXAMPLES 齋·齌·齍<br><br>HOMEPAGE ► 偏旁
⻬	qí<br>Variant of radical ⿑ (<b>even</b>)<br>EXAMPLES 齋·齌·齍<br><br>HOMEPAGE ► 偏旁
斉	qí<br>Variant of radical ⿑ (<b>even</b>)<br>EXAMPLES 齋·齌·齍<br><br>HOMEPAGE ► 偏旁
齊	qí<br>Variant of radical ⿑ (<b>even</b>)<br>EXAMPLES 齋·齌·齍<br><br>HOMEPAGE ► 偏旁
齐	qí<br>Variant of radical ⿑ (<b>even</b>)<br>EXAMPLES 齋·齌·齍<br><br>HOMEPAGE ► 偏旁
⿑	qí<br>Kangxi radical number 210<br>NAME  <br>VARIANTS ⻫·⻬·斉·齊·齐<br>STANDALONE 齐<br>MEANING <b>even</b><br>EXAMPLES 齋·齌·齍<br><br>HOMEPAGE ► 偏旁
⻭	chǐ<br>Variant of radical ⿒ (<b>tooth</b>)<br>EXAMPLES 齔·齕·齖<br><br>HOMEPAGE ► 偏旁
⻮	chǐ<br>Variant of radical ⿒ (<b>tooth</b>)<br>EXAMPLES 齔·齕·齖<br><br>HOMEPAGE ► 偏旁
歯	chǐ<br>Variant of radical ⿒ (<b>tooth</b>)<br>EXAMPLES 齔·齕·齖<br><br>HOMEPAGE ► 偏旁
齒	chǐ<br>Variant of radical ⿒ (<b>tooth</b>)<br>EXAMPLES 齔·齕·齖<br><br>HOMEPAGE ► 偏旁
齿	chǐ<br>Variant of radical ⿒ (<b>tooth</b>)<br>EXAMPLES 齔·齕·齖<br><br>HOMEPAGE ► 偏旁
⿒	chǐ<br>Kangxi radical number 211<br>NAME  <br>VARIANTS ⻭·⻮·歯·齒·齿<br>STANDALONE 齿<br>MEANING <b>tooth</b><br>EXAMPLES 齔·齕·齖<br><br>HOMEPAGE ► 偏旁
⻯	lóng<br>Variant of radical ⿓ (<b>dragon</b>)<br>EXAMPLES 龏·龑·龔<br><br>HOMEPAGE ► 偏旁
⻰	lóng<br>Variant of radical ⿓ (<b>dragon</b>)<br>EXAMPLES 龏·龑·龔<br><br>HOMEPAGE ► 偏旁
竜	lóng<br>Variant of radical ⿓ (<b>dragon</b>)<br>EXAMPLES 龏·龑·龔<br><br>HOMEPAGE ► 偏旁
龍	lóng<br>Variant of radical ⿓ (<b>dragon</b>)<br>EXAMPLES 龏·龑·龔<br><br>HOMEPAGE ► 偏旁
龙	lóng<br>Variant of radical ⿓ (<b>dragon</b>)<br>EXAMPLES 龏·龑·龔<br><br>HOMEPAGE ► 偏旁
⿓	lóng<br>Kangxi radical number 212<br>NAME  <br>VARIANTS ⻯·⻰·竜·龍·龙<br>STANDALONE 龙<br>MEANING <b>dragon</b><br>EXAMPLES 龏·龑·龔<br><br>HOMEPAGE ► 偏旁
⻱	guī<br>Variant of radical ⿔ (<b>turtle</b>)<br>EXAMPLES 䶰·龝·龞<br><br>HOMEPAGE ► 偏旁
⻲	guī<br>Variant of radical ⿔ (<b>turtle</b>)<br>EXAMPLES 䶰·龝·龞<br><br>HOMEPAGE ► 偏旁
⻳	guī<br>Variant of radical ⿔ (<b>turtle</b>)<br>EXAMPLES 䶰·龝·龞<br><br>HOMEPAGE ► 偏旁
亀	guī<br>Variant of radical ⿔ (<b>turtle</b>)<br>EXAMPLES 䶰·龝·龞<br><br>HOMEPAGE ► 偏旁
龜	guī<br>Variant of radical ⿔ (<b>turtle</b>)<br>EXAMPLES 䶰·龝·龞<br><br>HOMEPAGE ► 偏旁
龟	guī<br>Variant of radical ⿔ (<b>turtle</b>)<br>EXAMPLES 䶰·龝·龞<br><br>HOMEPAGE ► 偏旁
⿔	guī<br>Kangxi radical number 213<br>NAME  <br>VARIANTS ⻱·⻲·⻳·亀·龜·龟<br>STANDALONE 龟<br>MEANING <b>turtle</b><br>EXAMPLES 䶰·龝·龞<br><br>HOMEPAGE ► 偏旁
龠	yuè<br>Variant of radical ⿕ (<b>flute</b>)<br>EXAMPLES 龡·龢·龤<br><br>HOMEPAGE ► 偏旁
⿕	yuè<br>Kangxi radical number 214<br>NAME  <br>VARIANTS 龠<br>STANDALONE 龠<br>MEANING <b>flute</b><br>EXAMPLES 龡·龢·龤<br>MNEMONIC <i> a mouth blowing 亼 a flute with holes 口, possibly pan-pipes</i><br>RANK 20.0%<br><br>HOMEPAGE ► 偏旁
有名字	yǒu míngzì<br>RADICALS WITH NAMES<br>⼀ yīzìpáng 一字旁 <b>one</b><br>⼂ zhǔzìpáng 丶字旁 <b>dot</b><br>⼇ lìuzìtóu 六字头 <b>lid</b><br>⼈ dānlìrén 单立人 <b>man</b><br>⼈ dānrénpáng 单人旁 <b>man</b><br>⼉ érzuòdǐ 儿座底 <b>son, legs</b><br>⼊ rùzìpáng 入字旁 <b>enter</b><br>⼋ bāzìpáng 八字旁 <b>eight</b><br>⼌ tóngzìkuāng 同字匡 <b>wide</b><br>⼍ tūbǎogài 秃宝盖 <b>cloth cover</b><br>⼎ liǎngdiǎnshǔi 两点水 <b>ice</b><br>⼏ jīzìpáng 几字旁 <b>table</b><br>⼐ xiōngzìkuàng 凶字框 <b>receptacle</b><br>⼑ dāozìpáng 刀字旁 <b>knife</b><br>⼑ lìdāopáng 立刀旁 <b>knife</b><br>⼒ lìzìpáng 力字旁 <b>power</b><br>⼓ bāozìtóu 包字头 <b>wrap</b><br>⼔ bǐzìpáng 匕字旁 <b>spoon</b><br>⼕ yìzìkuàng 医字框 <b>box</b><br>⼗ shízìpáng 十字旁 <b>ten</b><br>⼙ dāněrdāo 单耳刀 <b>seal (device)</b><br>⼚ chǎngzìpáng 厂字旁 <b>cliff</b><br>⼛ sīzìpáng 私字旁 <b>private</b><br>⼜ yòuzìpáng 又字旁 <b>again</b><br>⼝ kǒuzìpáng 口字旁 <b>mouth</b><br>⼞ guózìkuàng 国字框 <b>enclosure</b><br>⼟ títǔpáng 提土旁 <b>earth</b><br>⼠ shìzìpáng 士字旁 <b>scholar</b><br>⼡ zhéwénpáng 折文旁 <b>go</b><br>⼣ xīzìpáng 夕字旁 <b>evening</b><br>⼤ dàzìpáng 大字旁 <b>big</b><br>⼥ nv̌zìpáng 女字旁 <b>woman</b><br>⼦ zǐzìpáng 子字旁 <b>child</b><br>⼧ bǎogàitóu 宝盖头 <b>roof</b><br>⼨ cùnzìpáng 寸字旁 <b>inch</b><br>⼩ dāngzìtóu 当字头 <b>small</b><br>⼫ shīzìtóu 尸字头 <b>corpse</b><br>⼭ shānzìpáng 山字旁 <b>mountain</b><br>⼯ gōngzìpáng 工字旁 <b>work</b><br>⼱ jīnzìér 巾字儿 <b>turban</b><br>⼲ gānzìpáng 干字旁 <b>dry</b><br>⼴ guǎngzìpáng 广字旁 <b>dotted cliff</b><br>⼵ jiànzhīpáng 建之旁 <b>long stride</b><br>⼶ nòngzìdǐ 弄字底 <b>arch</b><br>⼸ gōngzìpáng 弓字旁 <b>bow</b><br>⼺ sānpiěr 三撇儿 <b>bristle</b><br>⼻ shuānglìrén 双立人 <b>step</b><br>⼼ shùxīnpáng 竖心旁 <b>heart</b><br>⼽ gēzìpáng 戈字旁 <b>halberd</b><br>⼾ hùzìpáng 户字旁 <b>door</b><br>⼿ tíshǒupáng 提手旁 <b>hand</b><br>⼿ kànzìtóu 看字头 <b>hand</b><br>⽁ fǎnwénpáng 反文旁 <b>rap, tap</b><br>⽁ jìufǎnwénpáng 旧反文旁 <b>rap, tap</b><br>⽄ jīnzìpáng 斤字旁 <b>axe</b><br>⽅ fāngzìpáng 方字旁 <b>square</b><br>⽇ rìzìpáng 日字旁 <b>sun</b><br>⽉ yuèzìpáng 月字旁 <b>moon</b><br>⽊ mùzìpáng 木字旁 <b>tree</b><br>⽋ qiànzìpáng 欠字旁 <b>lack</b><br>⽌ zhǐzìpáng 止字旁 <b>stop</b><br>⽎ shūzìpáng 殳字旁 <b>weapon</b><br>⽔ sāndiǎnshǔi 三点水 <b>water</b><br>⽕ sìdiǎndǐ 四点底 <b>fire</b><br>⽕ huǒzìpáng 火字旁 <b>fire</b><br>⽖ shòuzìtóu 受字头 <b>claw</b><br>⽙ jiāngzìpáng 将字旁 <b>split wood</b><br>⽜ níuzìpáng 牛字旁 <b>cow</b><br>⽝ fǎnquǎnpáng 反犬旁 <b>dog</b><br>⽟ wángzìpáng 王字旁 <b>jade</b><br>⽥ tiánzìpáng 田字旁 <b>field</b><br>⽦ pǐzìdǐ 疋字底 <b>bolt of cloth</b><br>⽧ bìngzìpáng 病字旁 <b>sickness</b><br>⽨ dēngzìtóu 登字头 <b>footsteps</b><br>⽩ báizìpáng 白字旁 <b>white</b><br>⽪ pízìpáng 皮字旁 <b>skin</b><br>⽫ mǐnzìdǐ 皿字底 <b>dish</b><br>⽬ mùzìpáng 目字旁 <b>eye</b><br>⽯ shízìpáng 石字旁 <b>stone</b><br>⽰ shìzìpáng 示字旁 <b>spirit</b><br>⽲ hémùpáng 禾木旁 <b>grain</b><br>⽳ xuébǎogài 穴宝盖 <b>cave</b><br>⽴ lìzìpáng 立字旁 <b>stand</b><br>⽵ zhúzìtóu 竹字头 <b>bamboo</b><br>⽶ mǐzìpáng 米字旁 <b>rice</b><br>⽷ jiǎosīpáng 绞丝旁 <b>silk</b><br>⽹ sìzìtóu 四字头 <b>net</b><br>⽺ yángzìpáng 羊字旁 <b>sheep</b><br>⽻ yǔzìpáng 羽字旁 <b>feather</b><br>⽼ lǎozìtóu 老字头 <b>old</b><br>⽿ ěrzìpáng 耳字旁 <b>ear</b><br>⾆ shézìpáng 舌字旁 <b>tongue</b><br>⾈ zhōuzìpáng 舟字旁 <b>boat</b><br>⾉ gènzìpáng 艮字旁 <b>stopping</b><br>⾋ cǎozìtóu 草字头 <b>grass</b><br>⾍ chóngzìpáng 虫字旁 <b>insect</b><br>⾐ yīzìpáng 衣字旁 <b>clothes</b><br>⾒ jiànzìpáng 见字旁 <b>see</b><br>⾔ yánzìpáng 言字旁 <b>speech</b><br>⾙ bèizìpáng 贝字旁 <b>shell</b><br>⾛ zǒuzìpáng 走字旁 <b>run</b><br>⾜ zúzìpáng 足字旁 <b>foot</b><br>⾞ chēzìpáng 车字旁 <b>cart</b><br>⾟ xīnzìpáng 辛字旁 <b>bitter</b><br>⾡ zǒuzhīdǐ 走之底 <b>walk</b><br>⾢ yòuěrduǒ 右耳朵 <b>city</b><br>⾣ yǒuzìpáng 酉字旁 <b>wine</b><br>⾥ lǐzìpáng 里字旁 <b>village</b><br>⾦ jīnzìpáng 金字旁 <b>gold</b><br>⾨ ménzìkuàng 门字框 <b>gate</b><br>⾩ shuāngěrdāo 双耳刀 <b>mound</b><br>⾩ zuǒěrdāo 左耳刀 <b>mound</b><br>⾫ zhūizìpáng 隹字旁 <b>short-tailed bird</b><br>⾬ yǔzìtóu 雨字头 <b>rain</b><br>⾭ qīngzìpáng 青字旁 <b>blue</b><br>⾴ yèzìpáng 页字旁 <b>leaf</b><br>⾷ shízìpáng 食字旁 <b>eat</b><br>⾺ mǎzìpáng 马字旁 <b>horse</b><br>⿃ niǎozìpáng 鸟字旁 <b>bird</b><br><br><br>HOMEPAGE ► 偏旁
